{
"y": 2,
"biomeType": "HAUNTED",
"tileData": [
	[ 1, 21, 1, 1, 1, 7, 5, 8, 5, 5, 5, 7, 5, 5, 7, 7 ],
	[ 24, 1, 1, 1, 1, 5, 7, 5, 7, 5, 8, 5, 5, 8, 5, 7 ],
	[ 10, 1, 1, 10, 10, 7, 5, 5, 5, 7, 5, 5, 5, 9, 5, 7 ],
	[ 1, 1, 1, 1, 1, 5, 5, 7, 7, 9, 5, 1, 5, 5, 5, 7 ],
	[ 1, 1, 1, 10, 19, 5, 5, 7, 8, 5, 8, 5, 7, 5, 5, 7 ],
	[ 1, 24, 24, 10, 1, 1, 7, 8, 5, 7, 5, 7, 5, 7, 5, 5 ],
	[ 10, 1, 23, 18, 1, 1, 5, 5, 8, 5, 7, 5, 8, 7, 5, 7 ],
	[ 1, 24, 1, 1, 10, 10, 1, 5, 5, 7, 5, 5, 8, 5, 1, 9 ],
	[ 10, 10, 1, 1, 22, 1, 18, 5, 5, 5, 5, 5, 5, 5, 5, 5 ],
	[ 1, 10, 10, 1, 24, 19, 22, 1, 5, 5, 7, 5, 7, 8, 5, 5 ],
	[ 1, 1, 1, 10, 1, 23, 10, 1, 10, 8, 5, 5, 5, 5, 5, 8 ],
	[ 1, 1, 1, 10, 19, 1, 1, 10, 1, 1, 1, 5, 7, 5, 5, 9 ],
	[ 10, 1, 1, 1, 1, 1, 1, 1, 10, 1, 1, 1, 1, 1, 1, 1 ],
	[ 10, 1, 20, 10, 1, 1, 1, 10, 20, 23, 1, 1, 1, 21, 1, 1 ],
	[ 1, 10, 1, 1, 20, 21, 1, 1, 19, 10, 10, 10, 1, 1, 1, 20 ],
	[ 10, 1, 1, 18, 1, 1, 24, 20, 10, 1, 1, 10, 18, 1, 1, 10 ]
],
"objects": [
	{
		"x": 128,
		"y": 1024,
		"type": "HAUNTED_TREE"
	},
	{
		"x": 288,
		"y": 1376,
		"type": "HAUNTED_TREE"
	},
	{
		"x": 64,
		"y": 1248,
		"type": "HAUNTED_TREE"
	},
	{
		"x": 96,
		"y": 1440,
		"type": "HAUNTED_TREE"
	},
	{
		"x": 352,
		"y": 1024,
		"type": "HAUNTED_TREE"
	},
	{
		"x": 384,
		"y": 1248,
		"type": "HAUNTED_TREE"
	},
	{
		"x": 416,
		"y": 1472,
		"type": "HAUNTED_TREE"
	},
	{
		"y": 1024,
		"type": "HAUNTED_TREE"
	},
	{
		"x": 256,
		"y": 1248,
		"type": "HAUNTED_TREE"
	},
	{
		"x": 480,
		"y": 1088,
		"type": "HAUNTED_TREE"
	},
	{
		"x": 288,
		"y": 1504,
		"type": "HAUNTED_TREE"
	},
	{
		"x": 384,
		"y": 1344,
		"type": "POKEBALL"
	}
]
}