{
"x": 29,
"y": -17,
"biomeType": "PLAINS",
"tileData": [
	[ 20, 24, 21, 1, 1, 10, 1, 1, 1, 10, 1, 1, 1, 10, 1, 1 ],
	[ 18, 1, 1, 10, 1, 18, 10, 1, 20, 1, 1, 1, 10, 18, 1, 10 ],
	[ 1, 1, 1, 1, 1, 1, 1, 1, 1, 1, 1, 1, 10, 1, 1, 11 ],
	[ 1, 10, 21, 1, 1, 10, 1, 1, 18, 1, 20, 1, 1, 10, 10, 12 ],
	[ 1, 21, 10, 1, 10, 18, 1, 10, 10, 1, 10, 10, 10, 1, 19, 10 ],
	[ 18, 1, 10, 24, 10, 1, 10, 1, 1, 10, 1, 1, 1, 1, 10, 1 ],
	[ 1, 10, 1, 1, 1, 1, 1, 21, 1, 1, 10, 1, 1, 20, 1, 11 ],
	[ 1, 19, 10, 1, 1, 21, 1, 1, 24, 1, 1, 1, 1, 1, 20, 10 ],
	[ 18, 10, 1, 1, 1, 1, 1, 1, 1, 1, 1, 1, 1, 1, 1, 11 ],
	[ 10, 1, 1, 1, 1, 1, 21, 1, 1, 1, 1, 10, 1, 1, 10, 11 ],
	[ 1, 10, 1, 10, 10, 10, 1, 1, 1, 1, 1, 1, 1, 1, 1, 11 ],
	[ 19, 1, 1, 18, 19, 1, 1, 1, 21, 10, 1, 10, 1, 1, 10, 11 ],
	[ 10, 1, 18, 1, 10, 1, 1, 1, 10, 10, 10, 1, 1, 1, 1, 1 ],
	[ 1, 18, 21, 1, 1, 18, 22, 1, 10, 1, 1, 1, 19, 19, 1, 1 ],
	[ 1, 1, 1, 1, 1, 1, 1, 1, 21, 10, 1, 1, 1, 1, 10, 1 ],
	[ 19, 1, 1, 1, 10, 1, 1, 21, 1, 1, 10, 1, 1, 10, 20, 1 ]
],
"objects": [
	{
		"x": 15104,
		"y": -8576,
		"type": "TREE_0"
	},
	{
		"x": 14976,
		"y": -8704,
		"type": "TREE_0"
	},
	{
		"x": 15136,
		"y": -8352,
		"type": "TREE_0"
	},
	{
		"x": 14912,
		"y": -8480,
		"type": "TREE_0"
	},
	{
		"x": 14944,
		"y": -8288,
		"type": "TREE_0"
	},
	{
		"x": 15200,
		"y": -8704,
		"type": "TREE_0"
	},
	{
		"x": 15296,
		"y": -8352,
		"type": "TREE_0"
	},
	{
		"x": 15232,
		"y": -8480,
		"type": "TREE_0"
	},
	{
		"x": 14848,
		"y": -8704,
		"type": "TREE_0"
	},
	{
		"x": 15328,
		"y": -8608,
		"type": "TREE_0"
	},
	{
		"x": 15296,
		"y": -8224,
		"type": "TREE_0"
	}
]
}