{
"y": -3,
"biomeType": "FOREST",
"tileData": [
	[ 11, 11, 11, 11, 12, 1, 11, 11, 11, 1, 11, 1, 12, 11, 11, 1 ],
	[ 11, 12, 11, 11, 12, 11, 12, 11, 20, 12, 12, 12, 11, 11, 1, 20 ],
	[ 20, 11, 12, 12, 11, 11, 11, 11, 12, 10, 12, 11, 12, 1, 1, 11 ],
	[ 11, 12, 12, 11, 11, 11, 10, 11, 11, 11, 11, 11, 1, 11, 12, 1 ],
	[ 20, 12, 11, 11, 12, 11, 1, 11, 11, 11, 10, 10, 11, 11, 11, 11 ],
	[ 11, 11, 12, 11, 11, 11, 11, 12, 11, 11, 12, 10, 1, 11, 10, 11 ],
	[ 11, 11, 1, 10, 11, 1, 11, 11, 10, 12, 1, 1, 1, 12, 11, 11 ],
	[ 11, 11, 1, 11, 12, 12, 11, 11, 11, 20, 10, 12, 11, 11, 11, 12 ],
	[ 1, 11, 11, 1, 1, 11, 11, 1, 12, 12, 11, 12, 11, 11, 11, 11 ],
	[ 11, 11, 10, 11, 11, 12, 11, 11, 11, 10, 12, 11, 11, 1, 11, 1 ],
	[ 11, 12, 11, 11, 11, 11, 20, 12, 11, 12, 11, 10, 12, 11, 11, 11 ],
	[ 20, 11, 11, 11, 12, 12, 12, 11, 11, 11, 11, 10, 12, 11, 11, 1 ],
	[ 12, 11, 11, 1, 11, 11, 11, 12, 11, 11, 12, 11, 12, 11, 12, 11 ],
	[ 11, 11, 11, 11, 11, 1, 11, 11, 11, 12, 11, 11, 11, 11, 11, 11 ],
	[ 11, 12, 1, 11, 11, 1, 11, 10, 12, 1, 11, 1, 10, 11, 11, 1 ],
	[ 1, 12, 11, 1, 11, 11, 11, 11, 11, 1, 11, 11, 11, 12, 11, 12 ]
],
"objects": [
	{
		"x": 256,
		"y": -1408,
		"type": "TREE_0"
	},
	{
		"x": 128,
		"y": -1536,
		"type": "TREE_0"
	},
	{
		"x": 288,
		"y": -1184,
		"type": "TREE_0"
	},
	{
		"x": 64,
		"y": -1312,
		"type": "TREE_0"
	},
	{
		"x": 96,
		"y": -1120,
		"type": "TREE_0"
	},
	{
		"x": 352,
		"y": -1536,
		"type": "TREE_0"
	},
	{
		"x": 448,
		"y": -1184,
		"type": "TREE_0"
	},
	{
		"x": 384,
		"y": -1312,
		"type": "TREE_0"
	},
	{
		"y": -1536,
		"type": "TREE_0"
	},
	{
		"x": 480,
		"y": -1440,
		"type": "TREE_0"
	},
	{
		"x": 448,
		"y": -1056,
		"type": "TREE_0"
	},
	{
		"x": 288,
		"y": -1056,
		"type": "TREE_1"
	}
]
}