{
"x": 1,
"y": 1,
"biomeType": "PLAINS",
"tileData": [
	[ 1, 19, 1, 10, 1, 1, 1, 10, 10, 1, 1, 1, 1, 10, 19, 1 ],
	[ 1, 1, 1, 1, 1, 10, 1, 1, 19, 10, 22, 1, 1, 1, 20, 10 ],
	[ 10, 1, 19, 1, 1, 1, 1, 1, 1, 1, 1, 10, 1, 19, 10, 1 ],
	[ 1, 1, 1, 1, 10, 1, 1, 1, 1, 24, 1, 1, 24, 10, 1, 1 ],
	[ 10, 1, 10, 20, 10, 18, 1, 10, 1, 1, 10, 1, 1, 10, 1, 1 ],
	[ 24, 21, 1, 19, 1, 10, 1, 1, 1, 1, 1, 10, 1, 10, 1, 1 ],
	[ 1, 19, 24, 1, 1, 1, 10, 1, 1, 1, 10, 1, 1, 10, 10, 10 ],
	[ 1, 1, 1, 10, 1, 1, 18, 21, 19, 1, 1, 1, 18, 10, 1, 19 ],
	[ 19, 10, 1, 19, 1, 1, 1, 21, 1, 1, 1, 21, 1, 1, 1, 10 ],
	[ 1, 1, 1, 19, 19, 18, 21, 1, 1, 1, 10, 1, 21, 20, 10, 10 ],
	[ 1, 1, 1, 1, 18, 20, 10, 10, 1, 1, 10, 1, 1, 10, 1, 1 ],
	[ 1, 1, 1, 1, 1, 10, 1, 1, 18, 10, 1, 1, 1, 1, 1, 10 ],
	[ 24, 1, 1, 1, 19, 1, 1, 10, 21, 1, 21, 1, 1, 1, 23, 1 ],
	[ 1, 1, 19, 1, 10, 10, 1, 1, 1, 19, 1, 1, 1, 1, 1, 1 ],
	[ 1, 19, 10, 1, 1, 1, 1, 21, 1, 1, 10, 1, 1, 18, 21, 1 ],
	[ 1, 11, 10, 1, 1, 1, 12, 22, 10, 1, 11, 1, 11, 1, 19, 1 ]
],
"objects": [
	{
		"x": 768,
		"y": 640,
		"type": "TREE_0"
	},
	{
		"x": 640,
		"y": 512,
		"type": "TREE_0"
	},
	{
		"x": 800,
		"y": 864,
		"type": "TREE_0"
	},
	{
		"x": 576,
		"y": 736,
		"type": "TREE_0"
	},
	{
		"x": 608,
		"y": 928,
		"type": "TREE_0"
	},
	{
		"x": 864,
		"y": 512,
		"type": "TREE_0"
	},
	{
		"x": 960,
		"y": 864,
		"type": "TREE_0"
	},
	{
		"x": 896,
		"y": 736,
		"type": "TREE_0"
	},
	{
		"x": 512,
		"y": 512,
		"type": "TREE_0"
	},
	{
		"x": 992,
		"y": 608,
		"type": "TREE_0"
	},
	{
		"x": 960,
		"y": 992,
		"type": "TREE_0"
	},
	{
		"x": 800,
		"y": 992,
		"type": "TREE_1"
	},
	{
		"x": 512,
		"y": 800,
		"type": "POKEBALL"
	}
]
}