{
"x": 1,
"biomeType": "PLAINS",
"tileData": [
	[ 12, 11, 12, 1, 11, 10, 1, 21, 1, 10, 21, 1, 1, 1, 1, 1 ],
	[ 10, 11, 1, 12, 1, 12, 1, 10, 1, 22, 10, 1, 1, 1, 1, 10 ],
	[ 1, 1, 11, 11, 1, 1, 1, 10, 22, 1, 10, 1, 10, 1, 1, 10 ],
	[ 12, 11, 11, 19, 1, 1, 1, 1, 1, 1, 1, 24, 19, 18, 1, 10 ],
	[ 11, 11, 1, 1, 1, 1, 1, 10, 1, 1, 10, 10, 24, 1, 10, 1 ],
	[ 11, 11, 1, 10, 1, 1, 10, 1, 1, 1, 20, 1, 1, 1, 1, 1 ],
	[ 1, 1, 1, 11, 1, 10, 1, 10, 18, 10, 1, 1, 1, 1, 1, 1 ],
	[ 1, 21, 1, 20, 10, 1, 1, 1, 1, 1, 22, 1, 1, 1, 1, 10 ],
	[ 11, 1, 10, 1, 1, 1, 10, 1, 1, 10, 1, 1, 18, 1, 1, 1 ],
	[ 1, 10, 10, 1, 1, 10, 1, 1, 10, 1, 1, 1, 20, 1, 1, 18 ],
	[ 19, 1, 1, 1, 1, 1, 10, 1, 1, 1, 10, 19, 19, 1, 10, 10 ],
	[ 10, 1, 1, 10, 1, 1, 1, 10, 1, 10, 1, 10, 1, 1, 10, 1 ],
	[ 10, 10, 1, 1, 1, 22, 1, 1, 1, 20, 1, 1, 1, 10, 1, 10 ],
	[ 10, 1, 18, 1, 1, 10, 1, 1, 24, 10, 1, 1, 1, 10, 21, 1 ],
	[ 1, 1, 10, 1, 10, 1, 1, 24, 1, 1, 20, 10, 1, 21, 20, 1 ],
	[ 1, 1, 1, 10, 1, 1, 24, 1, 1, 22, 1, 1, 10, 1, 1, 10 ]
],
"objects": [
	{
		"x": 768,
		"y": 128,
		"type": "TREE_0"
	},
	{
		"x": 800,
		"y": 352,
		"type": "TREE_0"
	},
	{
		"x": 576,
		"y": 224,
		"type": "TREE_0"
	},
	{
		"x": 608,
		"y": 416,
		"type": "TREE_0"
	},
	{
		"x": 864,
		"type": "TREE_0"
	},
	{
		"x": 736,
		"type": "TREE_0"
	},
	{
		"x": 960,
		"y": 352,
		"type": "TREE_0"
	},
	{
		"x": 896,
		"y": 224,
		"type": "TREE_0"
	},
	{
		"x": 512,
		"y": 96,
		"type": "TREE_0"
	},
	{
		"x": 992,
		"y": 96,
		"type": "TREE_0"
	},
	{
		"x": 960,
		"y": 480,
		"type": "TREE_0"
	},
	{
		"x": 800,
		"y": 480,
		"type": "TREE_1"
	},
	{
		"x": 672,
		"y": 480,
		"type": "POKEBALL"
	}
]
}