{
"x": 29,
"y": -19,
"biomeType": "FOREST",
"tileData": [
	[ 11, 11, 11, 11, 1, 20, 10, 11, 11, 10, 10, 1, 1, 10, 1, 1 ],
	[ 10, 11, 1, 11, 12, 11, 11, 1, 10, 22, 1, 1, 1, 1, 1, 19 ],
	[ 11, 11, 11, 12, 11, 11, 11, 1, 1, 10, 1, 10, 1, 1, 1, 24 ],
	[ 12, 1, 12, 11, 11, 11, 1, 1, 1, 21, 1, 1, 10, 1, 19, 1 ],
	[ 11, 11, 10, 11, 11, 10, 11, 1, 1, 10, 1, 1, 1, 1, 10, 1 ],
	[ 1, 11, 11, 12, 11, 10, 12, 1, 1, 1, 1, 19, 1, 10, 18, 1 ],
	[ 11, 11, 11, 12, 12, 11, 1, 10, 1, 1, 20, 1, 1, 10, 10, 1 ],
	[ 11, 12, 11, 10, 10, 1, 11, 11, 18, 10, 1, 10, 1, 1, 1, 1 ],
	[ 11, 12, 11, 1, 11, 1, 11, 10, 1, 10, 1, 22, 20, 1, 10, 1 ],
	[ 12, 11, 1, 11, 11, 11, 11, 12, 1, 1, 24, 1, 1, 1, 1, 21 ],
	[ 11, 10, 11, 12, 11, 11, 1, 1, 11, 1, 1, 1, 1, 23, 1, 1 ],
	[ 12, 1, 20, 1, 11, 12, 1, 11, 1, 10, 1, 19, 1, 19, 19, 1 ],
	[ 22, 18, 1, 10, 12, 11, 11, 19, 10, 1, 1, 20, 1, 18, 21, 1 ],
	[ 20, 1, 10, 1, 1, 10, 1, 1, 1, 1, 1, 23, 1, 21, 19, 1 ],
	[ 1, 10, 20, 10, 1, 10, 1, 1, 1, 1, 1, 10, 1, 1, 1, 1 ],
	[ 1, 21, 1, 1, 20, 1, 1, 1, 18, 10, 22, 20, 1, 1, 1, 1 ]
],
"objects": [
	{
		"x": 15104,
		"y": -9600,
		"type": "TREE_0"
	},
	{
		"x": 14976,
		"y": -9728,
		"type": "TREE_0"
	},
	{
		"x": 15136,
		"y": -9376,
		"type": "TREE_0"
	},
	{
		"x": 14912,
		"y": -9504,
		"type": "TREE_0"
	},
	{
		"x": 14944,
		"y": -9312,
		"type": "TREE_0"
	},
	{
		"x": 15200,
		"y": -9728,
		"type": "TREE_0"
	},
	{
		"x": 15296,
		"y": -9376,
		"type": "TREE_0"
	},
	{
		"x": 15264,
		"y": -9504,
		"type": "TREE_0"
	},
	{
		"x": 14848,
		"y": -9728,
		"type": "TREE_0"
	},
	{
		"x": 15328,
		"y": -9632,
		"type": "TREE_0"
	},
	{
		"x": 15296,
		"y": -9248,
		"type": "TREE_0"
	}
]
}