{
"x": -1,
"biomeType": "PLAINS",
"tileData": [
	[ 1, 1, 1, 1, 21, 1, 24, 1, 10, 1, 1, 1, 7, 5, 8, 5 ],
	[ 1, 1, 10, 21, 20, 1, 1, 1, 1, 10, 1, 23, 5, 5, 5, 5 ],
	[ 1, 1, 1, 1, 24, 1, 10, 1, 1, 21, 1, 1, 5, 7, 5, 5 ],
	[ 1, 1, 1, 1, 1, 1, 1, 20, 1, 20, 10, 1, 1, 1, 5, 5 ],
	[ 10, 1, 10, 1, 10, 1, 1, 21, 10, 20, 10, 10, 1, 10, 5, 5 ],
	[ 10, 1, 1, 1, 1, 1, 21, 1, 1, 1, 10, 1, 1, 24, 5, 5 ],
	[ 10, 1, 10, 1, 1, 1, 21, 1, 1, 19, 1, 10, 1, 1, 7, 7 ],
	[ 1, 1, 1, 1, 1, 1, 1, 1, 20, 1, 18, 10, 24, 1, 22, 1 ],
	[ 10, 1, 1, 1, 10, 1, 24, 19, 1, 10, 10, 20, 1, 1, 19, 5 ],
	[ 1, 10, 1, 10, 1, 1, 1, 1, 21, 1, 1, 10, 1, 10, 1, 10 ],
	[ 1, 1, 1, 1, 1, 1, 1, 1, 1, 1, 10, 24, 10, 1, 10, 10 ],
	[ 1, 1, 1, 1, 1, 1, 1, 1, 10, 10, 21, 20, 1, 10, 1, 1 ],
	[ 1, 1, 18, 10, 1, 18, 1, 1, 1, 10, 20, 1, 1, 20, 10, 19 ],
	[ 1, 1, 1, 1, 20, 1, 1, 1, 1, 10, 1, 1, 1, 1, 19, 1 ],
	[ 1, 10, 1, 1, 1, 1, 22, 10, 1, 1, 1, 1, 1, 1, 20, 1 ],
	[ 1, 1, 1, 1, 20, 1, 10, 10, 1, 20, 10, 1, 1, 1, 18, 1 ]
],
"objects": [
	{
		"x": -256,
		"y": 128,
		"type": "TREE_0"
	},
	{
		"x": -384,
		"type": "TREE_0"
	},
	{
		"x": -224,
		"y": 352,
		"type": "TREE_0"
	},
	{
		"x": -448,
		"y": 224,
		"type": "TREE_0"
	},
	{
		"x": -416,
		"y": 416,
		"type": "TREE_0"
	},
	{
		"x": -160,
		"type": "TREE_0"
	},
	{
		"x": -64,
		"y": 352,
		"type": "TREE_0"
	},
	{
		"x": -128,
		"y": 224,
		"type": "TREE_0"
	},
	{
		"x": -512,
		"type": "TREE_0"
	},
	{
		"x": -32,
		"y": 96,
		"type": "TREE_0"
	},
	{
		"x": -64,
		"y": 480,
		"type": "TREE_0"
	},
	{
		"x": -224,
		"y": 480,
		"type": "TREE_1"
	},
	{
		"x": -320,
		"y": 128,
		"type": "POKEBALL"
	}
]
}