{
"x": -2,
"y": -3,
"biomeType": "FOREST",
"tileData": [
	[ 11, 1, 1, 1, 1, 18, 1, 1, 21, 1, 1, 1, 1, 1, 1, 1 ],
	[ 12, 20, 1, 1, 1, 1, 1, 18, 1, 1, 1, 1, 1, 10, 1, 1 ],
	[ 12, 11, 11, 1, 1, 1, 1, 19, 10, 10, 19, 1, 1, 20, 22, 1 ],
	[ 11, 12, 11, 1, 11, 1, 1, 1, 10, 1, 1, 1, 1, 1, 1, 10 ],
	[ 11, 1, 11, 11, 11, 12, 11, 11, 11, 18, 1, 1, 1, 1, 18, 1 ],
	[ 12, 10, 11, 11, 11, 11, 11, 12, 12, 11, 12, 12, 11, 10, 1, 1 ],
	[ 11, 11, 11, 1, 11, 11, 11, 11, 12, 12, 11, 11, 11, 1, 23, 1 ],
	[ 11, 11, 1, 11, 11, 12, 1, 11, 1, 12, 11, 11, 11, 11, 12, 1 ],
	[ 11, 11, 11, 11, 10, 11, 11, 12, 12, 11, 11, 11, 1, 11, 12, 12 ],
	[ 12, 11, 11, 1, 11, 12, 10, 12, 11, 11, 11, 1, 12, 1, 1, 11 ],
	[ 11, 11, 11, 1, 10, 12, 1, 11, 11, 1, 1, 11, 1, 1, 11, 11 ],
	[ 11, 1, 11, 1, 1, 10, 11, 12, 12, 11, 11, 12, 10, 11, 12, 11 ],
	[ 1, 1, 11, 1, 11, 11, 11, 11, 11, 1, 1, 12, 11, 11, 1, 11 ],
	[ 20, 12, 1, 12, 11, 11, 11, 12, 1, 12, 11, 11, 11, 12, 1, 11 ],
	[ 11, 11, 11, 11, 11, 1, 11, 12, 12, 11, 11, 11, 11, 12, 11, 20 ],
	[ 1, 11, 11, 11, 1, 11, 12, 12, 12, 11, 11, 12, 12, 11, 11, 12 ]
],
"objects": [
	{
		"x": -768,
		"y": -1408,
		"type": "TREE_0"
	},
	{
		"x": -896,
		"y": -1536,
		"type": "TREE_0"
	},
	{
		"x": -736,
		"y": -1184,
		"type": "TREE_0"
	},
	{
		"x": -992,
		"y": -1376,
		"type": "TREE_0"
	},
	{
		"x": -928,
		"y": -1120,
		"type": "TREE_0"
	},
	{
		"x": -672,
		"y": -1536,
		"type": "TREE_0"
	},
	{
		"x": -576,
		"y": -1184,
		"type": "TREE_0"
	},
	{
		"x": -640,
		"y": -1312,
		"type": "TREE_0"
	},
	{
		"x": -864,
		"y": -1248,
		"type": "TREE_0"
	},
	{
		"x": -1024,
		"y": -1536,
		"type": "TREE_0"
	},
	{
		"x": -544,
		"y": -1440,
		"type": "TREE_0"
	},
	{
		"x": -576,
		"y": -1056,
		"type": "TREE_0"
	},
	{
		"x": -736,
		"y": -1056,
		"type": "TREE_1"
	},
	{
		"x": -1024,
		"y": -1248,
		"type": "TREE_1"
	}
]
}