{
"x": 1,
"y": 3,
"biomeType": "PLAINS",
"tileData": [
	[ 20, 1, 22, 10, 21, 1, 1, 10, 1, 1, 1, 18, 1, 1, 1, 1 ],
	[ 24, 1, 23, 1, 1, 1, 1, 21, 1, 20, 10, 1, 1, 1, 1, 22 ],
	[ 10, 1, 1, 10, 1, 10, 1, 1, 1, 1, 10, 10, 1, 1, 24, 24 ],
	[ 1, 20, 10, 1, 1, 1, 1, 1, 1, 1, 10, 1, 1, 1, 1, 10 ],
	[ 20, 10, 1, 10, 1, 10, 1, 1, 10, 1, 1, 1, 1, 22, 1, 1 ],
	[ 10, 1, 1, 20, 23, 1, 10, 10, 1, 1, 10, 21, 1, 1, 10, 1 ],
	[ 1, 1, 21, 1, 1, 1, 10, 10, 19, 1, 1, 10, 22, 1, 1, 1 ],
	[ 1, 10, 1, 23, 1, 10, 1, 1, 1, 21, 1, 18, 1, 1, 10, 1 ],
	[ 1, 10, 10, 10, 10, 1, 19, 10, 1, 1, 19, 1, 10, 21, 1, 10 ],
	[ 1, 18, 1, 1, 1, 1, 18, 1, 18, 1, 1, 10, 1, 19, 10, 1 ],
	[ 10, 1, 1, 1, 1, 21, 10, 1, 19, 1, 1, 1, 21, 1, 22, 1 ],
	[ 1, 1, 10, 1, 1, 1, 1, 21, 1, 1, 1, 19, 1, 20, 19, 10 ],
	[ 1, 1, 1, 1, 1, 1, 1, 10, 1, 1, 1, 1, 1, 1, 10, 10 ],
	[ 1, 10, 1, 1, 1, 1, 1, 10, 1, 1, 1, 10, 10, 1, 1, 1 ],
	[ 5, 1, 1, 1, 1, 1, 1, 1, 10, 1, 1, 19, 1, 1, 1, 10 ],
	[ 5, 7, 7, 9, 7, 5, 9, 7, 5, 1, 10, 10, 1, 1, 1, 1 ]
],
"objects": [
	{
		"x": 768,
		"y": 1664,
		"type": "TREE_0"
	},
	{
		"x": 640,
		"y": 1536,
		"type": "TREE_0"
	},
	{
		"x": 800,
		"y": 1888,
		"type": "TREE_0"
	},
	{
		"x": 576,
		"y": 1760,
		"type": "TREE_0"
	},
	{
		"x": 608,
		"y": 1952,
		"type": "TREE_0"
	},
	{
		"x": 864,
		"y": 1536,
		"type": "TREE_0"
	},
	{
		"x": 960,
		"y": 1888,
		"type": "TREE_0"
	},
	{
		"x": 896,
		"y": 1760,
		"type": "TREE_0"
	},
	{
		"x": 512,
		"y": 1536,
		"type": "TREE_0"
	},
	{
		"x": 960,
		"y": 2016,
		"type": "TREE_0"
	},
	{
		"x": 800,
		"y": 2016,
		"type": "TREE_1"
	},
	{
		"x": 768,
		"y": 1824,
		"type": "POKEBALL"
	}
]
}