{
"x": 29,
"y": -23,
"biomeType": "PLAINS",
"tileData": [
	[ 20, 1, 10, 1, 22, 1, 22, 1, 1, 1, 10, 1, 1, 24, 10, 1 ],
	[ 1, 1, 1, 1, 1, 1, 1, 1, 10, 1, 1, 21, 1, 1, 1, 1 ],
	[ 1, 10, 21, 1, 1, 1, 1, 1, 1, 1, 1, 10, 10, 1, 10, 1 ],
	[ 10, 10, 1, 21, 1, 1, 1, 1, 1, 1, 1, 22, 1, 1, 1, 10 ],
	[ 1, 20, 1, 10, 1, 1, 1, 1, 18, 1, 10, 1, 1, 1, 18, 1 ],
	[ 1, 20, 1, 1, 1, 1, 24, 10, 23, 24, 1, 10, 1, 10, 10, 1 ],
	[ 1, 20, 1, 1, 10, 1, 1, 10, 1, 10, 1, 1, 1, 1, 1, 1 ],
	[ 1, 1, 1, 1, 10, 10, 1, 1, 1, 1, 1, 1, 10, 1, 1, 1 ],
	[ 1, 10, 1, 1, 20, 20, 1, 1, 1, 10, 1, 1, 10, 18, 10, 1 ],
	[ 1, 1, 1, 10, 10, 24, 10, 10, 1, 1, 1, 1, 10, 1, 10, 1 ],
	[ 10, 18, 1, 10, 1, 10, 1, 18, 1, 10, 10, 10, 1, 1, 1, 1 ],
	[ 1, 1, 1, 1, 1, 1, 20, 1, 1, 10, 1, 1, 1, 1, 1, 1 ],
	[ 1, 24, 1, 1, 1, 1, 10, 1, 18, 1, 10, 1, 20, 10, 1, 1 ],
	[ 1, 1, 1, 1, 10, 18, 1, 10, 10, 1, 1, 1, 1, 19, 1, 1 ],
	[ 20, 1, 10, 1, 1, 20, 22, 1, 1, 10, 1, 1, 18, 10, 10, 10 ],
	[ 10, 10, 21, 1, 1, 1, 10, 10, 10, 1, 1, 1, 1, 10, 1, 10 ]
],
"objects": [
	{
		"x": 15104,
		"y": -11648,
		"type": "TREE_0"
	},
	{
		"x": 14976,
		"y": -11776,
		"type": "TREE_0"
	},
	{
		"x": 15136,
		"y": -11424,
		"type": "TREE_0"
	},
	{
		"x": 14912,
		"y": -11552,
		"type": "TREE_0"
	},
	{
		"x": 14944,
		"y": -11360,
		"type": "TREE_0"
	},
	{
		"x": 15200,
		"y": -11776,
		"type": "TREE_0"
	},
	{
		"x": 15296,
		"y": -11424,
		"type": "TREE_0"
	},
	{
		"x": 15232,
		"y": -11552,
		"type": "TREE_0"
	},
	{
		"x": 14848,
		"y": -11776,
		"type": "TREE_0"
	},
	{
		"x": 15328,
		"y": -11680,
		"type": "TREE_0"
	},
	{
		"x": 15296,
		"y": -11296,
		"type": "TREE_0"
	},
	{
		"x": 15136,
		"y": -11296,
		"type": "TREE_1"
	}
]
}