{
"x": -1,
"y": 3,
"biomeType": "HAUNTED",
"tileData": [
	[ 1, 10, 1, 1, 1, 1, 1, 1, 1, 10, 1, 18, 10, 1, 1, 20 ],
	[ 9, 7, 5, 7, 5, 1, 5, 5, 7, 5, 7, 5, 5, 5, 5, 5 ],
	[ 7, 5, 5, 7, 5, 9, 7, 7, 5, 7, 5, 7, 7, 5, 7, 5 ],
	[ 5, 5, 9, 7, 5, 5, 5, 5, 5, 7, 7, 7, 5, 5, 5, 7 ],
	[ 5, 1, 7, 7, 5, 5, 5, 8, 5, 5, 7, 9, 7, 7, 5, 5 ],
	[ 1, 5, 5, 5, 5, 5, 7, 5, 7, 5, 7, 5, 5, 5, 5, 7 ],
	[ 5, 5, 8, 5, 5, 5, 5, 8, 7, 7, 7, 5, 5, 5, 5, 9 ],
	[ 7, 5, 5, 5, 7, 9, 5, 5, 8, 5, 5, 5, 7, 5, 5, 5 ],
	[ 7, 5, 5, 7, 8, 8, 5, 7, 5, 5, 5, 7, 7, 5, 5, 5 ],
	[ 5, 5, 5, 1, 5, 5, 9, 7, 5, 5, 1, 5, 5, 7, 5, 5 ],
	[ 5, 5, 5, 5, 5, 9, 7, 5, 5, 7, 5, 5, 5, 7, 5, 7 ],
	[ 7, 7, 5, 7, 7, 7, 5, 5, 9, 7, 5, 7, 7, 7, 5, 1 ],
	[ 1, 7, 5, 8, 5, 5, 7, 5, 8, 8, 5, 5, 5, 7, 5, 5 ],
	[ 5, 7, 5, 5, 5, 5, 5, 7, 5, 7, 5, 5, 5, 5, 5, 8 ],
	[ 1, 5, 7, 5, 9, 8, 5, 7, 5, 5, 5, 7, 7, 5, 8, 7 ],
	[ 7, 5, 5, 8, 5, 5, 5, 5, 5, 5, 7, 7, 7, 5, 5, 7 ]
],
"objects": [
	{
		"x": -480,
		"y": 1696,
		"type": "TREE_0"
	},
	{
		"x": -384,
		"y": 1568,
		"type": "TREE_0"
	},
	{
		"x": -512,
		"y": 2016,
		"type": "TREE_0"
	},
	{
		"x": -512,
		"y": 1536,
		"type": "TREE_0"
	},
	{
		"x": -512,
		"y": 1888,
		"type": "TREE_0"
	},
	{
		"x": -224,
		"y": 1856,
		"type": "TREE_0"
	},
	{
		"x": -160,
		"y": 2016,
		"type": "TREE_1"
	},
	{
		"x": -128,
		"y": 1536,
		"type": "TREE_1"
	},
	{
		"x": -512,
		"y": 1952,
		"type": "POKEBALL"
	}
]
}