{
"x": 28,
"y": -19,
"biomeType": "FOREST",
"tileData": [
	[ 10, 10, 10, 10, 20, 21, 1, 1, 10, 1, 10, 11, 11, 12, 12, 11 ],
	[ 1, 10, 1, 1, 1, 1, 20, 10, 1, 10, 10, 12, 11, 11, 11, 11 ],
	[ 1, 1, 10, 1, 1, 1, 1, 1, 1, 1, 10, 11, 1, 11, 11, 11 ],
	[ 1, 1, 10, 1, 24, 1, 1, 1, 1, 1, 11, 11, 12, 11, 11, 11 ],
	[ 22, 20, 1, 1, 1, 1, 10, 10, 1, 11, 12, 11, 11, 11, 11, 10 ],
	[ 19, 1, 1, 1, 10, 1, 12, 19, 10, 11, 10, 11, 11, 1, 11, 11 ],
	[ 1, 1, 1, 1, 10, 24, 1, 10, 1, 12, 11, 11, 11, 1, 11, 11 ],
	[ 10, 1, 1, 1, 11, 1, 11, 1, 12, 11, 11, 10, 11, 11, 10, 11 ],
	[ 18, 1, 1, 1, 1, 1, 19, 12, 11, 11, 12, 11, 12, 11, 11, 11 ],
	[ 1, 1, 1, 12, 1, 20, 12, 11, 11, 11, 11, 11, 12, 12, 11, 11 ],
	[ 11, 11, 10, 12, 1, 12, 11, 12, 1, 10, 11, 11, 11, 11, 12, 10 ],
	[ 1, 11, 10, 11, 11, 11, 11, 12, 20, 11, 11, 11, 11, 11, 11, 11 ],
	[ 11, 11, 12, 11, 11, 12, 11, 11, 1, 20, 11, 11, 11, 11, 12, 1 ],
	[ 11, 1, 11, 11, 12, 1, 11, 11, 12, 12, 1, 1, 21, 1, 1, 11 ],
	[ 12, 12, 11, 11, 12, 1, 11, 1, 12, 11, 11, 10, 1, 10, 20, 1 ],
	[ 12, 11, 11, 11, 10, 20, 11, 1, 11, 11, 12, 11, 18, 1, 1, 1 ]
],
"objects": [
	{
		"x": 14592,
		"y": -9600,
		"type": "TREE_0"
	},
	{
		"x": 14464,
		"y": -9728,
		"type": "TREE_0"
	},
	{
		"x": 14400,
		"y": -9504,
		"type": "TREE_0"
	},
	{
		"x": 14688,
		"y": -9728,
		"type": "TREE_0"
	},
	{
		"x": 14784,
		"y": -9376,
		"type": "TREE_0"
	},
	{
		"x": 14464,
		"y": -9248,
		"type": "TREE_0"
	},
	{
		"x": 14336,
		"y": -9728,
		"type": "TREE_0"
	},
	{
		"x": 14656,
		"y": -9440,
		"type": "TREE_0"
	},
	{
		"x": 14784,
		"y": -9248,
		"type": "TREE_0"
	},
	{
		"x": 14784,
		"y": -9568,
		"type": "TREE_0"
	},
	{
		"x": 14528,
		"y": -9472,
		"type": "TREE_1"
	}
]
}