{
"x": 23,
"y": -18,
"biomeType": "HAUNTED",
"tileData": [
	[ 5, 5, 5, 5, 5, 5, 1, 5, 5, 8, 5, 5, 5, 5, 5, 9 ],
	[ 5, 7, 7, 5, 7, 5, 5, 5, 5, 7, 5, 5, 5, 5, 5, 5 ],
	[ 7, 7, 5, 8, 1, 5, 5, 5, 5, 7, 5, 8, 5, 7, 5, 5 ],
	[ 5, 7, 7, 9, 5, 5, 7, 5, 5, 9, 7, 1, 5, 5, 5, 5 ],
	[ 5, 5, 7, 5, 5, 5, 5, 7, 5, 8, 1, 8, 5, 7, 7, 7 ],
	[ 5, 8, 5, 5, 5, 5, 5, 7, 7, 5, 7, 5, 5, 5, 5, 8 ],
	[ 5, 5, 8, 5, 7, 5, 5, 5, 7, 5, 7, 5, 5, 5, 8, 8 ],
	[ 7, 5, 9, 5, 5, 5, 7, 8, 1, 7, 5, 5, 5, 5, 5, 5 ],
	[ 5, 5, 5, 7, 7, 7, 5, 5, 9, 5, 7, 5, 5, 5, 7, 5 ],
	[ 7, 5, 5, 7, 5, 7, 5, 8, 5, 5, 5, 5, 5, 7, 7, 5 ],
	[ 5, 7, 5, 5, 5, 7, 7, 5, 7, 8, 7, 5, 5, 5, 5, 5 ],
	[ 5, 5, 5, 5, 1, 7, 7, 7, 7, 5, 8, 9, 5, 5, 5, 1 ],
	[ 5, 5, 5, 5, 8, 5, 5, 8, 9, 1, 7, 5, 5, 5, 5, 5 ],
	[ 7, 5, 5, 5, 5, 5, 7, 7, 5, 5, 5, 7, 5, 7, 7, 5 ],
	[ 5, 1, 7, 5, 5, 8, 7, 5, 7, 5, 7, 5, 7, 7, 5, 5 ],
	[ 7, 5, 5, 7, 7, 5, 5, 1, 8, 5, 5, 5, 5, 1, 1, 7 ]
],
"objects": [
	{
		"x": 12032,
		"y": -9088,
		"type": "HAUNTED_TREE"
	},
	{
		"x": 11904,
		"y": -9216,
		"type": "HAUNTED_TREE"
	},
	{
		"x": 12064,
		"y": -8864,
		"type": "HAUNTED_TREE"
	},
	{
		"x": 11840,
		"y": -8992,
		"type": "HAUNTED_TREE"
	},
	{
		"x": 11872,
		"y": -8800,
		"type": "HAUNTED_TREE"
	},
	{
		"x": 12128,
		"y": -9216,
		"type": "HAUNTED_TREE"
	},
	{
		"x": 12224,
		"y": -8864,
		"type": "HAUNTED_TREE"
	},
	{
		"x": 12160,
		"y": -8992,
		"type": "HAUNTED_TREE"
	},
	{
		"x": 11776,
		"y": -9216,
		"type": "HAUNTED_TREE"
	},
	{
		"x": 12256,
		"y": -9120,
		"type": "HAUNTED_TREE"
	},
	{
		"x": 12224,
		"y": -8736,
		"type": "HAUNTED_TREE"
	},
	{
		"x": 12064,
		"y": -8736,
		"type": "HAUNTED_TREE"
	}
]
}