{
"x": 27,
"y": -18,
"biomeType": "PLAINS",
"tileData": [
	[ 10, 1, 1, 10, 22, 1, 1, 24, 1, 1, 1, 1, 1, 18, 1, 10 ],
	[ 10, 1, 1, 1, 1, 1, 1, 10, 10, 1, 1, 10, 1, 1, 10, 1 ],
	[ 1, 10, 1, 10, 19, 1, 1, 1, 1, 1, 1, 10, 10, 1, 1, 1 ],
	[ 1, 1, 1, 1, 10, 21, 1, 1, 1, 18, 10, 20, 1, 1, 19, 1 ],
	[ 1, 10, 10, 1, 1, 1, 1, 1, 21, 1, 1, 1, 1, 19, 19, 1 ],
	[ 21, 1, 1, 10, 1, 18, 21, 1, 1, 1, 10, 1, 1, 1, 1, 18 ],
	[ 1, 1, 1, 1, 1, 10, 1, 1, 10, 10, 1, 1, 1, 21, 1, 1 ],
	[ 1, 1, 1, 10, 19, 1, 1, 21, 10, 1, 18, 21, 1, 1, 1, 1 ],
	[ 23, 1, 10, 1, 1, 1, 20, 1, 10, 10, 11, 11, 1, 24, 10, 1 ],
	[ 1, 10, 1, 11, 11, 10, 11, 11, 11, 11, 11, 11, 11, 11, 11, 11 ],
	[ 10, 10, 1, 11, 1, 11, 11, 1, 1, 1, 11, 12, 12, 11, 11, 12 ],
	[ 11, 10, 11, 11, 12, 11, 11, 12, 10, 12, 1, 10, 11, 12, 12, 11 ],
	[ 12, 12, 11, 12, 11, 11, 10, 11, 11, 12, 1, 11, 12, 11, 11, 10 ],
	[ 11, 11, 11, 11, 11, 12, 11, 11, 11, 11, 11, 10, 1, 11, 1, 20 ],
	[ 11, 11, 11, 12, 10, 11, 11, 11, 11, 11, 11, 1, 1, 11, 10, 11 ],
	[ 11, 11, 12, 11, 11, 11, 11, 12, 11, 11, 11, 11, 11, 20, 11, 11 ]
],
"objects": [
	{
		"x": 14080,
		"y": -9088,
		"type": "TREE_0"
	},
	{
		"x": 13952,
		"y": -9216,
		"type": "TREE_0"
	},
	{
		"x": 13888,
		"y": -8992,
		"type": "TREE_0"
	},
	{
		"x": 13920,
		"y": -8800,
		"type": "TREE_0"
	},
	{
		"x": 14272,
		"y": -8864,
		"type": "TREE_0"
	},
	{
		"x": 14080,
		"y": -8928,
		"type": "TREE_0"
	},
	{
		"x": 13824,
		"y": -9216,
		"type": "TREE_0"
	},
	{
		"x": 14080,
		"y": -8768,
		"type": "TREE_0"
	},
	{
		"x": 14144,
		"y": -9216,
		"type": "TREE_0"
	},
	{
		"x": 14272,
		"y": -9088,
		"type": "TREE_0"
	}
]
}