{
"x": 23,
"y": -20,
"biomeType": "HAUNTED",
"tileData": [
	[ 7, 5, 5, 5, 5, 8, 7, 5, 7, 5, 5, 5, 5, 8, 7, 5 ],
	[ 5, 7, 5, 5, 8, 5, 7, 5, 8, 7, 5, 7, 5, 5, 5, 5 ],
	[ 7, 5, 5, 5, 5, 5, 5, 5, 7, 5, 1, 5, 5, 7, 5, 5 ],
	[ 1, 5, 7, 5, 5, 7, 5, 7, 5, 5, 5, 5, 5, 5, 7, 5 ],
	[ 5, 9, 5, 7, 5, 5, 5, 5, 5, 5, 7, 5, 9, 5, 5, 7 ],
	[ 5, 5, 7, 5, 5, 5, 7, 5, 9, 5, 5, 5, 9, 7, 7, 5 ],
	[ 7, 5, 5, 5, 9, 8, 5, 5, 7, 5, 7, 5, 5, 7, 7, 5 ],
	[ 5, 5, 5, 5, 5, 8, 5, 5, 7, 5, 8, 7, 9, 5, 7, 5 ],
	[ 5, 7, 5, 5, 5, 5, 5, 5, 5, 7, 5, 5, 5, 7, 5, 7 ],
	[ 5, 5, 7, 5, 1, 7, 7, 5, 7, 5, 5, 7, 5, 7, 5, 9 ],
	[ 9, 7, 9, 5, 7, 5, 7, 5, 5, 5, 5, 7, 5, 7, 5, 5 ],
	[ 7, 7, 7, 7, 5, 5, 5, 5, 7, 5, 5, 5, 5, 7, 5, 1 ],
	[ 5, 7, 7, 5, 5, 8, 5, 5, 5, 5, 5, 7, 9, 5, 5, 7 ],
	[ 5, 7, 5, 5, 7, 5, 5, 7, 7, 5, 1, 1, 5, 7, 8, 7 ],
	[ 5, 5, 7, 5, 7, 5, 5, 5, 7, 7, 8, 5, 5, 5, 5, 5 ],
	[ 5, 7, 5, 5, 5, 5, 5, 5, 5, 5, 7, 5, 7, 7, 7, 7 ]
],
"objects": [
	{
		"x": 12032,
		"y": -10112,
		"type": "HAUNTED_TREE"
	},
	{
		"x": 11904,
		"y": -10240,
		"type": "HAUNTED_TREE"
	},
	{
		"x": 12064,
		"y": -9888,
		"type": "HAUNTED_TREE"
	},
	{
		"x": 11840,
		"y": -10016,
		"type": "HAUNTED_TREE"
	},
	{
		"x": 11872,
		"y": -9824,
		"type": "HAUNTED_TREE"
	},
	{
		"x": 12128,
		"y": -10240,
		"type": "HAUNTED_TREE"
	},
	{
		"x": 12224,
		"y": -9888,
		"type": "HAUNTED_TREE"
	},
	{
		"x": 12160,
		"y": -10016,
		"type": "HAUNTED_TREE"
	},
	{
		"x": 11776,
		"y": -10240,
		"type": "HAUNTED_TREE"
	},
	{
		"x": 12256,
		"y": -10144,
		"type": "HAUNTED_TREE"
	},
	{
		"x": 12224,
		"y": -9760,
		"type": "HAUNTED_TREE"
	},
	{
		"x": 12064,
		"y": -9760,
		"type": "HAUNTED_TREE"
	}
]
}