{
"x": 28,
"y": -20,
"biomeType": "FOREST",
"tileData": [
	[ 18, 20, 1, 20, 1, 1, 1, 22, 1, 1, 1, 1, 10, 1, 1, 19 ],
	[ 1, 1, 1, 1, 1, 19, 10, 24, 10, 1, 1, 1, 10, 20, 22, 1 ],
	[ 1, 1, 1, 1, 1, 1, 1, 10, 1, 10, 10, 1, 10, 1, 1, 10 ],
	[ 12, 1, 1, 1, 10, 1, 10, 18, 1, 10, 10, 1, 1, 1, 1, 1 ],
	[ 1, 10, 1, 1, 10, 1, 22, 1, 1, 1, 1, 1, 1, 1, 10, 1 ],
	[ 11, 10, 20, 10, 1, 12, 1, 1, 10, 1, 21, 1, 1, 1, 10, 1 ],
	[ 12, 12, 11, 20, 11, 11, 1, 11, 1, 20, 1, 1, 1, 10, 1, 21 ],
	[ 11, 11, 12, 12, 11, 11, 11, 11, 10, 22, 1, 1, 10, 1, 10, 1 ],
	[ 11, 12, 11, 11, 11, 12, 11, 11, 11, 11, 11, 11, 21, 1, 1, 1 ],
	[ 12, 11, 11, 11, 12, 1, 1, 1, 11, 11, 11, 11, 12, 10, 1, 1 ],
	[ 11, 11, 11, 11, 12, 12, 10, 12, 11, 11, 12, 12, 10, 20, 11, 11 ],
	[ 11, 11, 12, 11, 1, 12, 1, 11, 10, 1, 11, 1, 20, 11, 11, 12 ],
	[ 11, 1, 11, 11, 12, 10, 11, 12, 12, 12, 1, 12, 11, 11, 12, 1 ],
	[ 11, 11, 12, 12, 11, 11, 11, 1, 12, 11, 11, 11, 11, 1, 12, 11 ],
	[ 11, 11, 11, 1, 11, 11, 10, 10, 1, 1, 10, 11, 11, 11, 11, 11 ],
	[ 11, 11, 12, 11, 11, 1, 11, 11, 10, 12, 11, 10, 11, 1, 11, 10 ]
],
"objects": [
	{
		"x": 14464,
		"y": -10240,
		"type": "TREE_0"
	},
	{
		"x": 14400,
		"y": -10016,
		"type": "TREE_0"
	},
	{
		"x": 14432,
		"y": -9824,
		"type": "TREE_0"
	},
	{
		"x": 14624,
		"y": -10080,
		"type": "TREE_0"
	},
	{
		"x": 14624,
		"y": -9792,
		"type": "TREE_0"
	},
	{
		"x": 14752,
		"y": -10016,
		"type": "TREE_0"
	},
	{
		"x": 14336,
		"y": -10240,
		"type": "TREE_0"
	},
	{
		"x": 14528,
		"y": -9952,
		"type": "TREE_0"
	},
	{
		"x": 14816,
		"y": -9760,
		"type": "TREE_0"
	},
	{
		"x": 14720,
		"y": -10208,
		"type": "TREE_1"
	}
]
}