{
"x": 27,
"y": -19,
"biomeType": "PLAINS",
"tileData": [
	[ 24, 21, 1, 1, 1, 10, 10, 10, 1, 24, 1, 1, 1, 1, 22, 1 ],
	[ 10, 1, 1, 1, 10, 20, 1, 10, 1, 1, 1, 10, 1, 24, 10, 1 ],
	[ 1, 18, 1, 10, 1, 1, 1, 24, 1, 1, 1, 1, 23, 21, 10, 1 ],
	[ 10, 1, 10, 1, 1, 1, 1, 10, 10, 10, 10, 1, 1, 10, 20, 1 ],
	[ 10, 1, 21, 22, 1, 1, 22, 1, 10, 1, 1, 1, 1, 1, 1, 1 ],
	[ 1, 1, 1, 21, 1, 18, 1, 10, 1, 18, 10, 10, 19, 1, 10, 10 ],
	[ 1, 10, 1, 1, 18, 1, 1, 10, 1, 1, 10, 20, 10, 1, 20, 1 ],
	[ 1, 19, 19, 1, 1, 1, 1, 1, 10, 1, 21, 1, 10, 19, 21, 1 ],
	[ 1, 1, 1, 1, 1, 1, 1, 21, 1, 21, 1, 10, 1, 1, 1, 20 ],
	[ 10, 1, 1, 1, 1, 1, 1, 21, 1, 1, 10, 1, 20, 1, 1, 1 ],
	[ 1, 1, 1, 1, 20, 10, 1, 1, 1, 1, 20, 10, 19, 10, 19, 1 ],
	[ 1, 1, 1, 18, 1, 1, 1, 10, 1, 10, 18, 10, 1, 20, 11, 11 ],
	[ 1, 10, 1, 10, 20, 1, 1, 1, 10, 1, 1, 1, 1, 11, 12, 11 ],
	[ 19, 1, 10, 1, 1, 10, 1, 18, 1, 1, 1, 1, 1, 11, 11, 12 ],
	[ 24, 1, 1, 19, 1, 10, 1, 1, 1, 1, 1, 1, 11, 11, 11, 11 ],
	[ 1, 1, 1, 1, 10, 10, 1, 10, 1, 1, 1, 1, 12, 11, 12, 11 ]
],
"objects": [
	{
		"x": 14080,
		"y": -9600,
		"type": "TREE_0"
	},
	{
		"x": 13952,
		"y": -9728,
		"type": "TREE_0"
	},
	{
		"x": 14112,
		"y": -9376,
		"type": "TREE_0"
	},
	{
		"x": 13888,
		"y": -9504,
		"type": "TREE_0"
	},
	{
		"x": 13920,
		"y": -9312,
		"type": "TREE_0"
	},
	{
		"x": 14176,
		"y": -9728,
		"type": "TREE_0"
	},
	{
		"x": 14272,
		"y": -9376,
		"type": "TREE_0"
	},
	{
		"x": 14208,
		"y": -9504,
		"type": "TREE_0"
	},
	{
		"x": 13824,
		"y": -9728,
		"type": "TREE_0"
	},
	{
		"x": 14304,
		"y": -9632,
		"type": "TREE_0"
	},
	{
		"x": 14112,
		"y": -9248,
		"type": "TREE_1"
	}
]
}