{
"x": -2,
"y": 3,
"biomeType": "HAUNTED",
"tileData": [
	[ 5, 5, 7, 5, 5, 5, 7, 5, 5, 5, 5, 7, 5, 5, 5, 5 ],
	[ 7, 1, 7, 7, 5, 5, 5, 5, 5, 9, 7, 5, 7, 1, 7, 5 ],
	[ 5, 7, 5, 5, 5, 9, 5, 7, 5, 5, 7, 5, 5, 5, 7, 8 ],
	[ 5, 5, 5, 5, 5, 7, 5, 8, 7, 5, 7, 8, 5, 7, 9, 7 ],
	[ 5, 5, 7, 1, 7, 5, 5, 5, 5, 7, 5, 5, 5, 7, 5, 5 ],
	[ 5, 5, 5, 8, 7, 1, 5, 5, 5, 5, 5, 9, 7, 7, 7, 5 ],
	[ 8, 9, 5, 5, 5, 7, 7, 5, 5, 1, 5, 5, 7, 5, 5, 5 ],
	[ 8, 7, 5, 7, 7, 7, 5, 9, 5, 5, 8, 5, 5, 5, 5, 5 ],
	[ 7, 5, 8, 5, 5, 5, 7, 7, 7, 5, 5, 5, 7, 5, 9, 7 ],
	[ 5, 1, 7, 5, 1, 7, 7, 7, 5, 7, 5, 7, 7, 7, 1, 5 ],
	[ 1, 1, 1, 7, 5, 5, 7, 8, 5, 7, 7, 7, 7, 5, 8, 7 ],
	[ 10, 1, 1, 1, 10, 1, 1, 10, 10, 10, 1, 10, 10, 1, 10, 1 ],
	[ 1, 10, 20, 1, 10, 1, 10, 1, 10, 22, 1, 10, 1, 1, 1, 19 ],
	[ 1, 1, 1, 10, 1, 10, 1, 20, 20, 1, 1, 10, 10, 1, 1, 10 ],
	[ 10, 10, 1, 20, 10, 1, 1, 1, 1, 1, 21, 10, 1, 19, 10, 1 ],
	[ 1, 1, 21, 1, 1, 1, 1, 1, 1, 1, 1, 1, 1, 24, 10, 10 ]
],
"objects": [
	{
		"x": -768,
		"y": 1664,
		"type": "HAUNTED_TREE"
	},
	{
		"x": -896,
		"y": 1536,
		"type": "HAUNTED_TREE"
	},
	{
		"x": -736,
		"y": 1888,
		"type": "HAUNTED_TREE"
	},
	{
		"x": -960,
		"y": 1760,
		"type": "HAUNTED_TREE"
	},
	{
		"x": -928,
		"y": 1952,
		"type": "HAUNTED_TREE"
	},
	{
		"x": -640,
		"y": 1760,
		"type": "HAUNTED_TREE"
	},
	{
		"x": -608,
		"y": 1984,
		"type": "HAUNTED_TREE"
	},
	{
		"x": -1024,
		"y": 1536,
		"type": "HAUNTED_TREE"
	},
	{
		"x": -544,
		"y": 1632,
		"type": "HAUNTED_TREE"
	},
	{
		"x": -704,
		"y": 1536,
		"type": "HAUNTED_TREE"
	},
	{
		"x": -736,
		"y": 2016,
		"type": "HAUNTED_TREE"
	},
	{
		"x": -608,
		"y": 1568,
		"type": "POKEBALL"
	}
]
}