{
"x": -2,
"y": -1,
"biomeType": "PLAINS",
"tileData": [
	[ 10, 20, 1, 1, 1, 1, 1, 10, 19, 10, 1, 24, 1, 1, 10, 24 ],
	[ 20, 1, 1, 22, 1, 1, 1, 1, 10, 10, 1, 1, 1, 1, 22, 20 ],
	[ 24, 10, 1, 1, 1, 10, 1, 10, 10, 1, 10, 1, 1, 1, 1, 21 ],
	[ 10, 10, 1, 1, 1, 10, 1, 1, 1, 10, 10, 1, 10, 10, 1, 1 ],
	[ 1, 1, 1, 1, 10, 10, 1, 1, 10, 1, 1, 1, 10, 24, 10, 1 ],
	[ 1, 1, 1, 21, 20, 1, 18, 1, 1, 1, 18, 10, 10, 1, 10, 1 ],
	[ 1, 19, 1, 1, 1, 1, 1, 1, 10, 10, 1, 10, 18, 21, 1, 1 ],
	[ 1, 1, 10, 1, 1, 10, 1, 1, 1, 10, 1, 1, 10, 1, 1, 1 ],
	[ 1, 20, 10, 18, 1, 1, 10, 1, 21, 10, 1, 1, 1, 1, 1, 20 ],
	[ 1, 1, 1, 19, 1, 10, 1, 10, 10, 10, 10, 1, 1, 1, 10, 1 ],
	[ 10, 10, 1, 1, 10, 10, 20, 1, 1, 1, 1, 1, 22, 1, 10, 1 ],
	[ 1, 19, 1, 18, 10, 10, 1, 1, 1, 1, 1, 10, 10, 1, 19, 1 ],
	[ 1, 1, 1, 23, 1, 1, 1, 20, 1, 1, 19, 1, 1, 10, 1, 1 ],
	[ 1, 1, 10, 1, 1, 1, 10, 1, 1, 10, 1, 1, 21, 1, 1, 1 ],
	[ 1, 1, 1, 1, 1, 20, 1, 10, 1, 1, 1, 23, 19, 1, 10, 24 ],
	[ 21, 1, 10, 1, 10, 1, 1, 1, 10, 1, 21, 1, 10, 1, 24, 1 ]
],
"objects": [
	{
		"x": -768,
		"y": -384,
		"type": "TREE_0"
	},
	{
		"x": -896,
		"y": -512,
		"type": "TREE_0"
	},
	{
		"x": -736,
		"y": -160,
		"type": "TREE_0"
	},
	{
		"x": -960,
		"y": -288,
		"type": "TREE_0"
	},
	{
		"x": -928,
		"y": -96,
		"type": "TREE_0"
	},
	{
		"x": -672,
		"y": -512,
		"type": "TREE_0"
	},
	{
		"x": -576,
		"y": -160,
		"type": "TREE_0"
	},
	{
		"x": -640,
		"y": -288,
		"type": "TREE_0"
	},
	{
		"x": -1024,
		"y": -512,
		"type": "TREE_0"
	},
	{
		"x": -544,
		"y": -416,
		"type": "TREE_0"
	},
	{
		"x": -576,
		"y": -32,
		"type": "TREE_0"
	},
	{
		"x": -736,
		"y": -32,
		"type": "TREE_1"
	},
	{
		"x": -544,
		"y": -96,
		"type": "POKEBALL"
	}
]
}