{
"y": 1,
"biomeType": "PLAINS",
"tileData": [
	[ 1, 1, 1, 10, 1, 1, 1, 1, 1, 1, 1, 1, 1, 10, 1, 1 ],
	[ 1, 1, 1, 1, 10, 1, 1, 1, 1, 1, 1, 1, 1, 1, 1, 1 ],
	[ 10, 1, 10, 1, 1, 1, 10, 10, 1, 1, 1, 1, 1, 1, 23, 1 ],
	[ 10, 20, 10, 1, 22, 1, 10, 1, 1, 1, 1, 1, 10, 1, 1, 1 ],
	[ 10, 1, 1, 24, 1, 1, 1, 10, 1, 10, 20, 10, 1, 1, 1, 1 ],
	[ 1, 10, 1, 1, 10, 1, 10, 10, 1, 1, 1, 24, 1, 1, 1, 22 ],
	[ 10, 19, 1, 1, 1, 10, 1, 1, 20, 1, 1, 1, 10, 1, 1, 1 ],
	[ 24, 1, 1, 1, 10, 1, 1, 1, 1, 1, 10, 10, 1, 1, 1, 1 ],
	[ 21, 1, 1, 1, 1, 19, 21, 1, 10, 1, 1, 1, 10, 1, 22, 23 ],
	[ 1, 10, 1, 1, 1, 24, 1, 24, 1, 10, 1, 10, 1, 1, 1, 1 ],
	[ 1, 10, 1, 21, 1, 1, 10, 1, 1, 1, 1, 10, 1, 1, 1, 1 ],
	[ 1, 1, 10, 10, 1, 1, 10, 1, 1, 10, 23, 1, 23, 1, 19, 1 ],
	[ 1, 1, 1, 10, 1, 1, 19, 10, 10, 1, 1, 1, 1, 1, 1, 1 ],
	[ 1, 20, 1, 1, 10, 1, 1, 18, 1, 19, 10, 1, 1, 1, 1, 1 ],
	[ 1, 10, 1, 1, 1, 1, 1, 23, 1, 1, 1, 1, 1, 18, 1, 20 ],
	[ 1, 1, 1, 1, 1, 10, 10, 21, 21, 1, 10, 1, 1, 1, 10, 20 ]
],
"objects": [
	{
		"x": 256,
		"y": 640,
		"type": "TREE_0"
	},
	{
		"x": 128,
		"y": 512,
		"type": "TREE_0"
	},
	{
		"x": 288,
		"y": 864,
		"type": "TREE_0"
	},
	{
		"x": 64,
		"y": 736,
		"type": "TREE_0"
	},
	{
		"x": 96,
		"y": 928,
		"type": "TREE_0"
	},
	{
		"x": 352,
		"y": 512,
		"type": "TREE_0"
	},
	{
		"x": 448,
		"y": 864,
		"type": "TREE_0"
	},
	{
		"x": 384,
		"y": 736,
		"type": "TREE_0"
	},
	{
		"y": 512,
		"type": "TREE_0"
	},
	{
		"x": 480,
		"y": 608,
		"type": "TREE_0"
	},
	{
		"x": 448,
		"y": 992,
		"type": "TREE_0"
	},
	{
		"x": 288,
		"y": 992,
		"type": "TREE_1"
	},
	{
		"x": 320,
		"y": 576,
		"type": "POKEBALL"
	}
]
}