{
"x": 2,
"biomeType": "FOREST",
"tileData": [
	[ 24, 1, 1, 1, 21, 1, 20, 1, 1, 10, 1, 19, 10, 11, 19, 1 ],
	[ 1, 10, 1, 1, 1, 1, 1, 1, 10, 1, 18, 1, 1, 12, 1, 1 ],
	[ 1, 1, 10, 1, 1, 10, 23, 10, 1, 20, 1, 1, 1, 10, 11, 11 ],
	[ 1, 1, 19, 1, 1, 1, 1, 11, 11, 1, 1, 11, 1, 11, 11, 11 ],
	[ 10, 1, 1, 10, 10, 1, 11, 21, 12, 11, 12, 10, 11, 11, 1, 1 ],
	[ 1, 10, 1, 1, 10, 1, 11, 11, 10, 11, 10, 11, 11, 11, 12, 11 ],
	[ 1, 10, 1, 1, 1, 11, 1, 1, 11, 1, 11, 11, 10, 12, 12, 12 ],
	[ 1, 1, 1, 1, 11, 11, 12, 12, 12, 11, 11, 11, 11, 11, 1, 12 ],
	[ 20, 1, 1, 1, 11, 11, 1, 10, 11, 11, 12, 12, 1, 11, 12, 11 ],
	[ 1, 1, 1, 22, 18, 11, 20, 11, 11, 11, 20, 10, 11, 1, 11, 11 ],
	[ 1, 1, 1, 20, 11, 11, 11, 11, 12, 10, 11, 1, 12, 10, 11, 12 ],
	[ 1, 23, 11, 10, 11, 11, 11, 11, 12, 11, 10, 11, 11, 11, 11, 11 ],
	[ 1, 12, 1, 1, 11, 11, 12, 11, 11, 12, 20, 11, 11, 11, 1, 12 ],
	[ 1, 11, 11, 11, 11, 11, 12, 1, 12, 1, 11, 11, 1, 10, 11, 1 ],
	[ 1, 11, 1, 11, 11, 11, 12, 12, 12, 11, 11, 11, 12, 11, 1, 12 ],
	[ 10, 11, 1, 11, 11, 11, 11, 12, 11, 11, 11, 11, 1, 1, 12, 11 ]
],
"objects": [
	{
		"x": 1280,
		"y": 128,
		"type": "TREE_0"
	},
	{
		"x": 1152,
		"type": "TREE_0"
	},
	{
		"x": 1312,
		"y": 352,
		"type": "TREE_0"
	},
	{
		"x": 1088,
		"y": 224,
		"type": "TREE_0"
	},
	{
		"x": 1120,
		"y": 416,
		"type": "TREE_0"
	},
	{
		"x": 1376,
		"type": "TREE_0"
	},
	{
		"x": 1472,
		"y": 352,
		"type": "TREE_0"
	},
	{
		"x": 1408,
		"y": 224,
		"type": "TREE_0"
	},
	{
		"x": 1024,
		"y": 96,
		"type": "TREE_0"
	},
	{
		"x": 1504,
		"y": 96,
		"type": "TREE_0"
	},
	{
		"x": 1472,
		"y": 480,
		"type": "TREE_0"
	},
	{
		"x": 1312,
		"y": 480,
		"type": "TREE_1"
	},
	{
		"x": 1056,
		"type": "POKEBALL"
	}
]
}