{
"x": 27,
"y": -23,
"biomeType": "HAUNTED",
"tileData": [
	[ 7, 5, 7, 5, 9, 5, 5, 5, 5, 5, 8, 9, 5, 5, 7, 15 ],
	[ 8, 7, 8, 8, 5, 7, 1, 5, 5, 7, 7, 5, 5, 5, 9, 5 ],
	[ 5, 5, 9, 5, 5, 8, 7, 5, 7, 5, 7, 5, 9, 5, 5, 7 ],
	[ 5, 5, 5, 5, 5, 5, 5, 7, 5, 7, 5, 5, 5, 7, 7, 7 ],
	[ 5, 5, 5, 5, 7, 7, 7, 5, 5, 5, 5, 9, 5, 5, 5, 7 ],
	[ 5, 5, 7, 9, 5, 5, 7, 5, 7, 5, 7, 5, 5, 7, 5, 5 ],
	[ 5, 7, 7, 5, 5, 7, 5, 5, 8, 8, 5, 8, 5, 7, 5, 5 ],
	[ 7, 5, 5, 5, 1, 5, 5, 5, 5, 7, 5, 5, 5, 5, 1, 7 ],
	[ 7, 5, 5, 5, 5, 7, 5, 5, 5, 5, 7, 5, 7, 7, 1, 7 ],
	[ 5, 5, 5, 7, 7, 7, 5, 5, 5, 5, 5, 5, 7, 5, 5, 7 ],
	[ 7, 5, 5, 5, 8, 1, 5, 8, 8, 5, 5, 5, 5, 8, 9, 5 ],
	[ 9, 5, 7, 5, 7, 7, 7, 5, 7, 5, 5, 5, 5, 7, 5, 5 ],
	[ 5, 5, 5, 8, 5, 7, 7, 7, 7, 5, 8, 5, 5, 1, 7, 5 ],
	[ 5, 5, 5, 5, 8, 9, 5, 5, 5, 1, 5, 5, 7, 5, 5, 8 ],
	[ 5, 9, 5, 7, 7, 5, 5, 5, 8, 7, 5, 7, 7, 5, 5, 5 ],
	[ 5, 5, 8, 5, 5, 5, 5, 7, 7, 5, 5, 5, 5, 7, 5, 8 ]
],
"objects": [
	{
		"x": 14080,
		"y": -11648,
		"type": "HAUNTED_TREE"
	},
	{
		"x": 13952,
		"y": -11776,
		"type": "HAUNTED_TREE"
	},
	{
		"x": 14112,
		"y": -11424,
		"type": "HAUNTED_TREE"
	},
	{
		"x": 13888,
		"y": -11552,
		"type": "HAUNTED_TREE"
	},
	{
		"x": 13920,
		"y": -11360,
		"type": "HAUNTED_TREE"
	},
	{
		"x": 14176,
		"y": -11776,
		"type": "HAUNTED_TREE"
	},
	{
		"x": 14272,
		"y": -11424,
		"type": "HAUNTED_TREE"
	},
	{
		"x": 14208,
		"y": -11552,
		"type": "HAUNTED_TREE"
	},
	{
		"x": 13824,
		"y": -11776,
		"type": "HAUNTED_TREE"
	},
	{
		"x": 14304,
		"y": -11680,
		"type": "HAUNTED_TREE"
	},
	{
		"x": 14272,
		"y": -11296,
		"type": "HAUNTED_TREE"
	},
	{
		"x": 14112,
		"y": -11296,
		"type": "HAUNTED_TREE"
	}
]
}