{
"x": 23,
"y": -19,
"biomeType": "HAUNTED",
"tileData": [
	[ 5, 7, 5, 5, 5, 5, 5, 7, 7, 7, 1, 7, 7, 5, 5, 7 ],
	[ 5, 1, 7, 5, 5, 5, 9, 5, 8, 5, 9, 5, 5, 5, 5, 5 ],
	[ 7, 5, 7, 5, 5, 5, 5, 1, 5, 1, 5, 5, 9, 7, 7, 8 ],
	[ 5, 5, 5, 5, 5, 9, 1, 7, 7, 5, 5, 5, 7, 9, 7, 8 ],
	[ 7, 7, 5, 5, 7, 5, 7, 5, 7, 7, 5, 7, 8, 1, 5, 7 ],
	[ 5, 5, 7, 5, 5, 5, 5, 7, 5, 5, 7, 5, 5, 9, 5, 5 ],
	[ 5, 9, 1, 7, 5, 7, 7, 5, 8, 5, 5, 7, 5, 5, 5, 5 ],
	[ 7, 8, 5, 5, 5, 5, 5, 1, 9, 5, 5, 7, 5, 5, 5, 7 ],
	[ 8, 7, 1, 8, 5, 7, 5, 7, 8, 5, 5, 5, 5, 5, 5, 5 ],
	[ 7, 7, 5, 7, 5, 5, 8, 5, 9, 5, 5, 7, 5, 5, 7, 5 ],
	[ 7, 5, 7, 5, 7, 1, 5, 1, 9, 5, 5, 7, 5, 5, 7, 8 ],
	[ 5, 7, 7, 5, 7, 5, 5, 7, 5, 5, 5, 5, 1, 5, 7, 7 ],
	[ 7, 5, 7, 9, 9, 5, 7, 5, 5, 8, 8, 9, 5, 5, 5, 5 ],
	[ 7, 7, 5, 5, 9, 1, 5, 5, 8, 8, 5, 7, 5, 5, 7, 5 ],
	[ 5, 5, 7, 5, 5, 5, 5, 7, 5, 5, 5, 7, 7, 5, 7, 5 ],
	[ 5, 7, 7, 5, 5, 5, 5, 5, 5, 7, 8, 5, 5, 9, 5, 5 ]
],
"objects": [
	{
		"x": 12032,
		"y": -9600,
		"type": "HAUNTED_TREE"
	},
	{
		"x": 11904,
		"y": -9728,
		"type": "HAUNTED_TREE"
	},
	{
		"x": 12064,
		"y": -9376,
		"type": "HAUNTED_TREE"
	},
	{
		"x": 11840,
		"y": -9504,
		"type": "HAUNTED_TREE"
	},
	{
		"x": 11872,
		"y": -9312,
		"type": "HAUNTED_TREE"
	},
	{
		"x": 12128,
		"y": -9728,
		"type": "HAUNTED_TREE"
	},
	{
		"x": 12224,
		"y": -9376,
		"type": "HAUNTED_TREE"
	},
	{
		"x": 12160,
		"y": -9504,
		"type": "HAUNTED_TREE"
	},
	{
		"x": 11776,
		"y": -9728,
		"type": "HAUNTED_TREE"
	},
	{
		"x": 12256,
		"y": -9632,
		"type": "HAUNTED_TREE"
	},
	{
		"x": 12224,
		"y": -9248,
		"type": "HAUNTED_TREE"
	},
	{
		"x": 12064,
		"y": -9248,
		"type": "HAUNTED_TREE"
	}
]
}