{
"x": 25,
"y": -17,
"biomeType": "HAUNTED",
"tileData": [
	[ 7, 7, 5, 7, 5, 5, 5, 9, 7, 7, 7, 5, 5, 7, 5, 5 ],
	[ 7, 9, 8, 7, 5, 5, 5, 5, 9, 9, 7, 5, 5, 8, 1, 9 ],
	[ 5, 5, 5, 5, 1, 8, 5, 7, 5, 5, 5, 7, 9, 7, 5, 7 ],
	[ 5, 5, 5, 8, 7, 7, 1, 5, 7, 5, 5, 8, 5, 9, 5, 5 ],
	[ 5, 5, 8, 8, 5, 5, 8, 5, 5, 5, 5, 5, 8, 7, 5, 5 ],
	[ 7, 9, 5, 5, 1, 5, 5, 5, 5, 5, 7, 9, 8, 5, 7, 1 ],
	[ 7, 8, 5, 5, 5, 7, 5, 7, 7, 7, 5, 5, 5, 5, 1, 7 ],
	[ 5, 5, 5, 9, 5, 5, 7, 5, 5, 1, 5, 7, 5, 5, 7, 7 ],
	[ 5, 7, 5, 5, 7, 1, 7, 5, 5, 5, 5, 7, 7, 5, 5, 7 ],
	[ 7, 5, 5, 5, 1, 7, 7, 9, 5, 5, 7, 7, 5, 5, 7, 8 ],
	[ 7, 5, 5, 9, 5, 5, 9, 7, 5, 5, 5, 5, 7, 9, 7, 5 ],
	[ 5, 7, 8, 5, 5, 5, 5, 5, 7, 8, 5, 9, 5, 8, 5, 5 ],
	[ 5, 5, 7, 9, 7, 5, 5, 5, 8, 7, 5, 7, 5, 5, 5, 5 ],
	[ 5, 5, 5, 5, 7, 5, 5, 9, 5, 5, 9, 7, 5, 5, 7, 10 ],
	[ 5, 5, 8, 7, 5, 5, 5, 5, 7, 7, 5, 5, 7, 7, 7, 1 ],
	[ 5, 7, 8, 5, 5, 5, 7, 5, 5, 5, 5, 5, 8, 5, 1, 1 ]
],
"objects": [
	{
		"x": 13056,
		"y": -8576,
		"type": "HAUNTED_TREE"
	},
	{
		"x": 12928,
		"y": -8704,
		"type": "HAUNTED_TREE"
	},
	{
		"x": 13088,
		"y": -8352,
		"type": "HAUNTED_TREE"
	},
	{
		"x": 12864,
		"y": -8480,
		"type": "HAUNTED_TREE"
	},
	{
		"x": 12896,
		"y": -8288,
		"type": "HAUNTED_TREE"
	},
	{
		"x": 13152,
		"y": -8704,
		"type": "HAUNTED_TREE"
	},
	{
		"x": 13248,
		"y": -8352,
		"type": "HAUNTED_TREE"
	},
	{
		"x": 13184,
		"y": -8480,
		"type": "HAUNTED_TREE"
	},
	{
		"x": 12800,
		"y": -8704,
		"type": "HAUNTED_TREE"
	},
	{
		"x": 13280,
		"y": -8608,
		"type": "HAUNTED_TREE"
	},
	{
		"x": 13248,
		"y": -8224,
		"type": "HAUNTED_TREE"
	},
	{
		"x": 13088,
		"y": -8224,
		"type": "HAUNTED_TREE"
	}
]
}