{
"x": 27,
"y": -17,
"biomeType": "PLAINS",
"tileData": [
	[ 1, 10, 10, 10, 1, 1, 10, 10, 10, 1, 1, 1, 10, 21, 1, 1 ],
	[ 10, 10, 1, 1, 10, 10, 1, 1, 20, 10, 1, 10, 1, 1, 18, 21 ],
	[ 10, 1, 19, 21, 18, 1, 1, 1, 1, 1, 1, 1, 1, 10, 1, 1 ],
	[ 1, 1, 21, 18, 1, 1, 20, 1, 1, 20, 1, 1, 1, 1, 1, 10 ],
	[ 19, 1, 1, 1, 1, 10, 1, 10, 1, 1, 1, 10, 10, 10, 10, 1 ],
	[ 20, 10, 1, 1, 1, 1, 10, 23, 1, 1, 10, 1, 1, 10, 20, 1 ],
	[ 1, 1, 1, 19, 18, 21, 1, 10, 1, 1, 1, 10, 1, 18, 10, 1 ],
	[ 1, 10, 20, 1, 10, 10, 10, 1, 10, 1, 1, 1, 22, 10, 1, 10 ],
	[ 1, 20, 1, 1, 1, 1, 1, 10, 1, 21, 1, 1, 10, 1, 10, 1 ],
	[ 1, 1, 1, 21, 1, 1, 1, 24, 19, 10, 1, 1, 1, 1, 1, 1 ],
	[ 11, 12, 10, 10, 1, 1, 18, 1, 24, 1, 10, 1, 10, 1, 1, 10 ],
	[ 11, 10, 10, 1, 1, 1, 1, 10, 1, 1, 1, 10, 20, 1, 1, 1 ],
	[ 11, 12, 11, 1, 1, 21, 10, 21, 10, 1, 1, 1, 1, 1, 1, 10 ],
	[ 11, 11, 12, 12, 1, 10, 1, 10, 1, 1, 1, 1, 22, 10, 1, 1 ],
	[ 11, 10, 1, 11, 12, 19, 19, 1, 10, 18, 10, 1, 1, 10, 1, 1 ],
	[ 11, 11, 1, 11, 12, 1, 1, 10, 1, 1, 1, 1, 18, 1, 10, 1 ]
],
"objects": [
	{
		"x": 14080,
		"y": -8576,
		"type": "TREE_0"
	},
	{
		"x": 13952,
		"y": -8704,
		"type": "TREE_0"
	},
	{
		"x": 14112,
		"y": -8352,
		"type": "TREE_0"
	},
	{
		"x": 13888,
		"y": -8480,
		"type": "TREE_0"
	},
	{
		"x": 13920,
		"y": -8288,
		"type": "TREE_0"
	},
	{
		"x": 14272,
		"y": -8352,
		"type": "TREE_0"
	},
	{
		"x": 14208,
		"y": -8480,
		"type": "TREE_0"
	},
	{
		"x": 13824,
		"y": -8704,
		"type": "TREE_0"
	},
	{
		"x": 14272,
		"y": -8224,
		"type": "TREE_0"
	},
	{
		"x": 14304,
		"y": -8640,
		"type": "TREE_0"
	},
	{
		"x": 14112,
		"y": -8224,
		"type": "TREE_1"
	}
]
}