{
"x": 24,
"y": -17,
"biomeType": "HAUNTED",
"tileData": [
	[ 5, 9, 5, 7, 5, 5, 5, 5, 5, 5, 5, 7, 5, 5, 7, 5 ],
	[ 5, 8, 7, 7, 8, 5, 7, 5, 5, 7, 7, 5, 5, 5, 5, 8 ],
	[ 5, 5, 7, 7, 5, 5, 5, 5, 8, 7, 5, 5, 7, 5, 5, 5 ],
	[ 5, 7, 5, 5, 7, 7, 7, 8, 5, 8, 5, 7, 5, 1, 7, 7 ],
	[ 9, 5, 5, 5, 7, 7, 5, 7, 5, 5, 7, 7, 5, 5, 9, 5 ],
	[ 7, 5, 5, 7, 1, 5, 8, 5, 5, 7, 7, 5, 5, 5, 7, 5 ],
	[ 5, 7, 5, 5, 7, 5, 5, 5, 5, 5, 5, 5, 5, 7, 5, 5 ],
	[ 5, 5, 5, 9, 7, 5, 7, 5, 5, 7, 5, 5, 5, 5, 5, 5 ],
	[ 5, 7, 5, 7, 5, 5, 7, 9, 7, 5, 7, 5, 5, 5, 8, 7 ],
	[ 5, 5, 5, 5, 5, 7, 5, 5, 1, 9, 8, 5, 7, 7, 5, 7 ],
	[ 7, 5, 7, 7, 5, 8, 9, 9, 5, 7, 5, 7, 1, 5, 5, 9 ],
	[ 8, 5, 5, 7, 5, 5, 7, 5, 7, 5, 7, 7, 5, 5, 1, 7 ],
	[ 5, 5, 5, 8, 5, 5, 1, 5, 5, 5, 7, 8, 7, 5, 5, 5 ],
	[ 5, 5, 5, 5, 5, 5, 5, 7, 7, 5, 5, 7, 5, 9, 5, 5 ],
	[ 7, 5, 5, 7, 5, 8, 5, 5, 5, 5, 7, 8, 5, 5, 5, 7 ],
	[ 7, 5, 5, 5, 5, 5, 5, 5, 5, 5, 1, 5, 5, 7, 5, 5 ]
],
"objects": [
	{
		"x": 12544,
		"y": -8576,
		"type": "HAUNTED_TREE"
	},
	{
		"x": 12416,
		"y": -8704,
		"type": "HAUNTED_TREE"
	},
	{
		"x": 12576,
		"y": -8352,
		"type": "HAUNTED_TREE"
	},
	{
		"x": 12352,
		"y": -8480,
		"type": "HAUNTED_TREE"
	},
	{
		"x": 12384,
		"y": -8288,
		"type": "HAUNTED_TREE"
	},
	{
		"x": 12640,
		"y": -8704,
		"type": "HAUNTED_TREE"
	},
	{
		"x": 12736,
		"y": -8352,
		"type": "HAUNTED_TREE"
	},
	{
		"x": 12672,
		"y": -8480,
		"type": "HAUNTED_TREE"
	},
	{
		"x": 12288,
		"y": -8704,
		"type": "HAUNTED_TREE"
	},
	{
		"x": 12768,
		"y": -8608,
		"type": "HAUNTED_TREE"
	},
	{
		"x": 12736,
		"y": -8224,
		"type": "HAUNTED_TREE"
	},
	{
		"x": 12576,
		"y": -8224,
		"type": "HAUNTED_TREE"
	}
]
}