{
"x": 3,
"y": -4,
"biomeType": "FOREST",
"tileData": [
	[ 11, 12, 11, 12, 11, 11, 11, 11, 11, 11, 12, 10, 1, 11, 11, 12 ],
	[ 11, 11, 10, 20, 11, 11, 12, 11, 11, 11, 11, 11, 1, 12, 11, 11 ],
	[ 11, 12, 12, 11, 12, 12, 1, 11, 11, 1, 11, 11, 1, 11, 11, 11 ],
	[ 11, 1, 11, 12, 11, 1, 11, 12, 11, 11, 20, 10, 11, 11, 11, 11 ],
	[ 1, 11, 11, 12, 11, 11, 12, 12, 1, 11, 1, 11, 11, 12, 11, 12 ],
	[ 12, 11, 12, 12, 11, 11, 12, 11, 11, 12, 11, 11, 10, 11, 11, 11 ],
	[ 11, 11, 10, 11, 11, 11, 11, 12, 11, 11, 11, 10, 1, 11, 1, 12 ],
	[ 11, 11, 11, 11, 12, 11, 11, 11, 12, 11, 10, 1, 11, 20, 1, 11 ],
	[ 11, 11, 11, 11, 11, 11, 11, 11, 11, 11, 1, 12, 11, 11, 10, 11 ],
	[ 11, 11, 11, 11, 11, 12, 12, 11, 12, 1, 1, 1, 12, 11, 11, 11 ],
	[ 11, 11, 12, 11, 12, 11, 11, 1, 12, 10, 1, 11, 11, 11, 11, 1 ],
	[ 1, 1, 12, 12, 11, 11, 11, 11, 11, 11, 12, 11, 11, 11, 12, 11 ],
	[ 12, 11, 11, 1, 11, 12, 1, 11, 11, 1, 1, 11, 11, 11, 11, 11 ],
	[ 11, 1, 11, 11, 11, 12, 11, 1, 20, 11, 11, 11, 12, 1, 11, 1 ],
	[ 11, 11, 11, 11, 1, 11, 11, 1, 11, 11, 12, 11, 11, 11, 1, 11 ],
	[ 12, 11, 11, 12, 11, 12, 10, 12, 11, 11, 11, 12, 11, 11, 10, 11 ]
],
"objects": [
	{
		"x": 1792,
		"y": -1920,
		"type": "TREE_0"
	},
	{
		"x": 1664,
		"y": -2048,
		"type": "TREE_0"
	},
	{
		"x": 1824,
		"y": -1696,
		"type": "TREE_0"
	},
	{
		"x": 1600,
		"y": -1824,
		"type": "TREE_0"
	},
	{
		"x": 1632,
		"y": -1632,
		"type": "TREE_0"
	},
	{
		"x": 1888,
		"y": -2048,
		"type": "TREE_0"
	},
	{
		"x": 1984,
		"y": -1696,
		"type": "TREE_0"
	},
	{
		"x": 1920,
		"y": -1824,
		"type": "TREE_0"
	},
	{
		"x": 1536,
		"y": -2048,
		"type": "TREE_0"
	},
	{
		"x": 2016,
		"y": -1952,
		"type": "TREE_0"
	},
	{
		"x": 1984,
		"y": -1568,
		"type": "TREE_0"
	},
	{
		"x": 1824,
		"y": -1568,
		"type": "TREE_1"
	}
]
}