{
"x": 28,
"y": -17,
"biomeType": "PLAINS",
"tileData": [
	[ 1, 1, 12, 12, 11, 1, 1, 1, 1, 1, 1, 1, 1, 1, 1, 1 ],
	[ 11, 1, 12, 1, 11, 1, 1, 10, 1, 1, 1, 1, 10, 24, 1, 1 ],
	[ 12, 20, 11, 11, 12, 19, 1, 1, 20, 1, 1, 19, 1, 1, 10, 22 ],
	[ 12, 11, 11, 11, 20, 10, 10, 22, 10, 1, 10, 1, 20, 1, 1, 21 ],
	[ 1, 11, 10, 1, 18, 10, 1, 1, 1, 1, 20, 1, 1, 1, 1, 1 ],
	[ 11, 11, 11, 12, 1, 1, 18, 1, 10, 19, 1, 10, 1, 1, 1, 1 ],
	[ 11, 1, 11, 10, 18, 11, 1, 1, 1, 19, 1, 1, 1, 1, 19, 1 ],
	[ 10, 22, 11, 21, 1, 1, 1, 1, 20, 10, 1, 1, 1, 1, 1, 20 ],
	[ 10, 1, 12, 10, 1, 10, 1, 10, 1, 1, 1, 1, 1, 1, 1, 1 ],
	[ 1, 12, 11, 1, 20, 1, 1, 1, 1, 1, 1, 1, 10, 1, 20, 1 ],
	[ 12, 1, 1, 1, 1, 10, 1, 1, 1, 1, 18, 1, 21, 1, 10, 1 ],
	[ 1, 1, 10, 10, 10, 1, 10, 1, 1, 1, 19, 1, 10, 19, 20, 1 ],
	[ 1, 1, 10, 1, 10, 1, 10, 1, 10, 1, 24, 1, 1, 18, 1, 1 ],
	[ 10, 10, 1, 10, 1, 1, 1, 20, 22, 10, 10, 1, 1, 1, 10, 1 ],
	[ 1, 1, 1, 18, 10, 1, 1, 1, 1, 1, 1, 18, 1, 10, 1, 24 ],
	[ 1, 1, 1, 1, 1, 1, 1, 1, 1, 1, 1, 1, 10, 20, 1, 1 ]
],
"objects": [
	{
		"x": 14592,
		"y": -8576,
		"type": "TREE_0"
	},
	{
		"x": 14464,
		"y": -8704,
		"type": "TREE_0"
	},
	{
		"x": 14624,
		"y": -8352,
		"type": "TREE_0"
	},
	{
		"x": 14400,
		"y": -8480,
		"type": "TREE_0"
	},
	{
		"x": 14432,
		"y": -8288,
		"type": "TREE_0"
	},
	{
		"x": 14688,
		"y": -8704,
		"type": "TREE_0"
	},
	{
		"x": 14720,
		"y": -8480,
		"type": "TREE_0"
	},
	{
		"x": 14752,
		"y": -8256,
		"type": "TREE_0"
	},
	{
		"x": 14336,
		"y": -8704,
		"type": "TREE_0"
	},
	{
		"x": 14816,
		"y": -8608,
		"type": "TREE_0"
	},
	{
		"x": 14624,
		"y": -8224,
		"type": "TREE_1"
	}
]
}