{
"y": -2,
"biomeType": "FOREST",
"tileData": [
	[ 12, 11, 12, 11, 11, 11, 12, 11, 11, 20, 12, 11, 12, 11, 11, 12 ],
	[ 11, 10, 10, 11, 11, 1, 11, 12, 11, 11, 11, 10, 11, 12, 1, 11 ],
	[ 11, 12, 11, 11, 1, 11, 11, 11, 11, 11, 11, 11, 1, 11, 11, 11 ],
	[ 12, 11, 11, 12, 11, 11, 20, 11, 11, 11, 20, 11, 1, 1, 12, 11 ],
	[ 11, 11, 11, 11, 12, 12, 12, 11, 12, 11, 11, 11, 11, 11, 11, 11 ],
	[ 11, 12, 10, 1, 1, 12, 11, 12, 10, 12, 11, 10, 11, 11, 11, 1 ],
	[ 1, 12, 11, 20, 11, 11, 11, 12, 11, 12, 1, 12, 11, 11, 12, 11 ],
	[ 12, 1, 11, 10, 11, 11, 20, 11, 11, 12, 1, 11, 11, 11, 12, 12 ],
	[ 12, 1, 11, 11, 11, 1, 11, 11, 11, 10, 11, 11, 1, 11, 11, 11 ],
	[ 11, 11, 11, 11, 1, 11, 11, 1, 11, 11, 12, 12, 12, 20, 12, 12 ],
	[ 11, 11, 10, 11, 1, 11, 12, 11, 11, 11, 11, 11, 11, 11, 12, 11 ],
	[ 11, 11, 11, 10, 11, 10, 11, 11, 11, 12, 11, 1, 12, 11, 11, 11 ],
	[ 12, 1, 20, 11, 1, 12, 11, 12, 12, 11, 11, 11, 12, 11, 11, 12 ],
	[ 20, 11, 11, 20, 12, 11, 11, 10, 1, 11, 11, 11, 11, 11, 1, 11 ],
	[ 11, 12, 20, 11, 11, 12, 12, 12, 11, 1, 12, 11, 12, 1, 10, 11 ],
	[ 1, 12, 11, 11, 11, 12, 1, 11, 12, 11, 11, 12, 1, 12, 11, 11 ]
],
"objects": [
	{
		"x": 256,
		"y": -896,
		"type": "TREE_0"
	},
	{
		"x": 128,
		"y": -1024,
		"type": "TREE_0"
	},
	{
		"x": 288,
		"y": -672,
		"type": "TREE_0"
	},
	{
		"x": 64,
		"y": -800,
		"type": "TREE_0"
	},
	{
		"x": 96,
		"y": -608,
		"type": "TREE_0"
	},
	{
		"x": 352,
		"y": -1024,
		"type": "TREE_0"
	},
	{
		"x": 448,
		"y": -672,
		"type": "TREE_0"
	},
	{
		"x": 384,
		"y": -800,
		"type": "TREE_0"
	},
	{
		"y": -1024,
		"type": "TREE_0"
	},
	{
		"x": 480,
		"y": -928,
		"type": "TREE_0"
	},
	{
		"x": 448,
		"y": -544,
		"type": "TREE_0"
	},
	{
		"x": 288,
		"y": -544,
		"type": "TREE_1"
	},
	{
		"x": 160,
		"y": -928,
		"type": "POKEBALL"
	}
]
}