{
"y": -4,
"biomeType": "FOREST",
"tileData": [
	[ 20, 10, 1, 10, 10, 10, 11, 1, 11, 11, 12, 11, 1, 1, 1, 11 ],
	[ 1, 1, 22, 19, 1, 1, 10, 11, 11, 12, 12, 11, 12, 1, 11, 11 ],
	[ 1, 1, 1, 1, 1, 1, 1, 12, 12, 10, 11, 1, 10, 11, 10, 11 ],
	[ 1, 1, 1, 1, 10, 1, 18, 11, 11, 11, 12, 12, 11, 12, 11, 11 ],
	[ 1, 10, 18, 1, 1, 10, 1, 1, 1, 12, 10, 11, 11, 1, 11, 11 ],
	[ 1, 20, 21, 1, 1, 1, 20, 11, 1, 11, 11, 11, 10, 11, 12, 10 ],
	[ 1, 1, 10, 1, 20, 1, 11, 10, 12, 11, 11, 1, 11, 11, 12, 11 ],
	[ 10, 1, 1, 1, 10, 12, 12, 11, 11, 11, 1, 11, 12, 12, 12, 11 ],
	[ 1, 1, 1, 21, 1, 11, 12, 11, 11, 10, 11, 1, 1, 10, 11, 11 ],
	[ 10, 21, 1, 1, 11, 11, 11, 11, 1, 11, 11, 1, 10, 11, 11, 12 ],
	[ 21, 1, 1, 20, 12, 11, 11, 10, 11, 1, 11, 11, 11, 11, 1, 11 ],
	[ 10, 10, 11, 12, 11, 11, 11, 11, 11, 12, 10, 11, 11, 12, 11, 11 ],
	[ 19, 11, 11, 11, 11, 1, 10, 11, 11, 10, 11, 11, 12, 11, 11, 12 ],
	[ 11, 10, 11, 12, 12, 11, 1, 10, 12, 11, 12, 20, 12, 11, 1, 12 ],
	[ 11, 11, 11, 11, 11, 11, 12, 10, 11, 10, 11, 1, 11, 10, 11, 11 ],
	[ 11, 11, 12, 11, 12, 12, 10, 11, 11, 12, 11, 20, 12, 1, 11, 11 ]
],
"objects": [
	{
		"x": 256,
		"y": -1920,
		"type": "TREE_0"
	},
	{
		"x": 128,
		"y": -2048,
		"type": "TREE_0"
	},
	{
		"x": 288,
		"y": -1696,
		"type": "TREE_0"
	},
	{
		"x": 32,
		"y": -1888,
		"type": "TREE_0"
	},
	{
		"x": 352,
		"y": -2048,
		"type": "TREE_0"
	},
	{
		"x": 448,
		"y": -1696,
		"type": "TREE_0"
	},
	{
		"x": 128,
		"y": -1632,
		"type": "TREE_0"
	},
	{
		"x": 416,
		"y": -1824,
		"type": "TREE_0"
	},
	{
		"y": -2048,
		"type": "TREE_0"
	},
	{
		"x": 160,
		"y": -1792,
		"type": "TREE_0"
	},
	{
		"y": -1664,
		"type": "TREE_1"
	}
]
}