{
"x": -1,
"y": -1,
"biomeType": "PLAINS",
"tileData": [
	[ 11, 11, 12, 20, 1, 10, 1, 1, 1, 1, 19, 1, 10, 20, 1, 1 ],
	[ 11, 10, 11, 11, 11, 11, 1, 10, 10, 1, 1, 1, 1, 10, 10, 1 ],
	[ 11, 11, 11, 12, 11, 11, 11, 1, 1, 1, 1, 1, 20, 10, 10, 1 ],
	[ 11, 11, 11, 10, 11, 11, 11, 11, 1, 1, 21, 1, 23, 10, 10, 1 ],
	[ 11, 11, 11, 11, 10, 20, 12, 11, 1, 20, 1, 1, 21, 1, 1, 18 ],
	[ 12, 11, 12, 12, 1, 11, 11, 11, 1, 10, 1, 21, 1, 1, 1, 10 ],
	[ 11, 1, 12, 1, 11, 11, 11, 11, 10, 10, 24, 18, 1, 10, 1, 18 ],
	[ 12, 12, 11, 11, 11, 11, 11, 1, 11, 11, 10, 1, 1, 10, 1, 1 ],
	[ 1, 1, 12, 11, 11, 11, 12, 11, 12, 10, 1, 1, 1, 23, 1, 1 ],
	[ 1, 11, 11, 11, 20, 12, 10, 11, 11, 11, 1, 1, 1, 1, 1, 20 ],
	[ 10, 11, 11, 11, 11, 11, 12, 10, 11, 10, 1, 10, 1, 10, 10, 1 ],
	[ 11, 11, 12, 11, 11, 10, 11, 11, 11, 1, 11, 11, 21, 1, 1, 1 ],
	[ 11, 20, 11, 11, 1, 11, 11, 11, 11, 11, 11, 11, 10, 1, 1, 1 ],
	[ 11, 11, 11, 1, 12, 11, 11, 12, 11, 11, 1, 12, 11, 11, 1, 1 ],
	[ 1, 11, 11, 11, 11, 11, 11, 1, 11, 1, 11, 11, 11, 1, 11, 1 ],
	[ 20, 11, 11, 11, 11, 12, 12, 12, 11, 1, 11, 11, 12, 10, 12, 21 ]
],
"objects": [
	{
		"x": -256,
		"y": -384,
		"type": "TREE_0"
	},
	{
		"x": -384,
		"y": -512,
		"type": "TREE_0"
	},
	{
		"x": -224,
		"y": -160,
		"type": "TREE_0"
	},
	{
		"x": -448,
		"y": -288,
		"type": "TREE_0"
	},
	{
		"x": -416,
		"y": -96,
		"type": "TREE_0"
	},
	{
		"x": -160,
		"y": -512,
		"type": "TREE_0"
	},
	{
		"x": -64,
		"y": -160,
		"type": "TREE_0"
	},
	{
		"x": -128,
		"y": -288,
		"type": "TREE_0"
	},
	{
		"x": -512,
		"y": -512,
		"type": "TREE_0"
	},
	{
		"x": -32,
		"y": -416,
		"type": "TREE_0"
	},
	{
		"x": -64,
		"y": -32,
		"type": "TREE_0"
	},
	{
		"x": -224,
		"y": -32,
		"type": "TREE_1"
	},
	{
		"x": -512,
		"y": -160,
		"type": "POKEBALL"
	}
]
}