{
"x": 29,
"y": -18,
"biomeType": "PLAINS",
"tileData": [
	[ 19, 1, 1, 1, 19, 1, 1, 1, 10, 1, 1, 10, 1, 10, 1, 1 ],
	[ 1, 1, 20, 1, 1, 10, 18, 10, 1, 1, 1, 1, 1, 1, 1, 1 ],
	[ 22, 21, 10, 1, 10, 1, 1, 1, 1, 1, 1, 10, 1, 10, 10, 1 ],
	[ 10, 1, 1, 10, 1, 1, 1, 18, 1, 1, 1, 1, 1, 10, 1, 1 ],
	[ 1, 1, 10, 1, 1, 1, 23, 10, 1, 1, 1, 1, 1, 1, 18, 1 ],
	[ 1, 18, 1, 10, 10, 23, 1, 1, 1, 20, 1, 1, 1, 10, 1, 1 ],
	[ 19, 18, 21, 1, 1, 21, 1, 1, 21, 1, 10, 1, 10, 1, 1, 1 ],
	[ 1, 1, 1, 1, 20, 1, 18, 1, 1, 1, 22, 10, 1, 10, 1, 10 ],
	[ 10, 1, 10, 1, 1, 10, 1, 1, 1, 1, 1, 1, 18, 1, 1, 1 ],
	[ 18, 10, 1, 1, 18, 1, 1, 1, 24, 1, 1, 18, 1, 1, 1, 1 ],
	[ 1, 10, 1, 1, 1, 1, 10, 10, 1, 1, 1, 1, 19, 1, 19, 18 ],
	[ 1, 1, 18, 1, 19, 1, 1, 10, 1, 19, 20, 20, 1, 1, 10, 1 ],
	[ 1, 21, 20, 10, 10, 21, 1, 1, 19, 1, 1, 1, 1, 10, 1, 1 ],
	[ 1, 1, 24, 1, 1, 21, 1, 20, 1, 1, 10, 1, 1, 1, 1, 24 ],
	[ 1, 1, 10, 10, 10, 1, 1, 20, 10, 10, 1, 1, 1, 10, 1, 10 ],
	[ 1, 10, 19, 1, 1, 18, 1, 1, 1, 19, 1, 1, 10, 1, 1, 10 ]
],
"objects": [
	{
		"x": 15104,
		"y": -9088,
		"type": "TREE_0"
	},
	{
		"x": 14976,
		"y": -9216,
		"type": "TREE_0"
	},
	{
		"x": 15136,
		"y": -8864,
		"type": "TREE_0"
	},
	{
		"x": 14912,
		"y": -8992,
		"type": "TREE_0"
	},
	{
		"x": 14944,
		"y": -8800,
		"type": "TREE_0"
	},
	{
		"x": 15200,
		"y": -9216,
		"type": "TREE_0"
	},
	{
		"x": 15296,
		"y": -8864,
		"type": "TREE_0"
	},
	{
		"x": 15232,
		"y": -8992,
		"type": "TREE_0"
	},
	{
		"x": 14848,
		"y": -9216,
		"type": "TREE_0"
	},
	{
		"x": 15328,
		"y": -9120,
		"type": "TREE_0"
	},
	{
		"x": 15296,
		"y": -8736,
		"type": "TREE_0"
	},
	{
		"x": 15136,
		"y": -8736,
		"type": "TREE_1"
	}
]
}