{
"x": -2,
"y": 2,
"biomeType": "PLAINS",
"tileData": [
	[ 1, 1, 1, 10, 1, 1, 1, 5, 5, 5, 7, 5, 9, 7, 5, 8 ],
	[ 10, 1, 10, 1, 10, 1, 1, 10, 8, 7, 5, 8, 7, 5, 5, 1 ],
	[ 10, 10, 10, 10, 10, 1, 10, 1, 5, 7, 7, 5, 5, 5, 1, 5 ],
	[ 18, 1, 10, 1, 1, 1, 1, 10, 1, 5, 5, 5, 7, 7, 7, 5 ],
	[ 10, 1, 1, 1, 1, 1, 1, 1, 22, 10, 5, 5, 5, 7, 7, 5 ],
	[ 1, 1, 1, 10, 1, 18, 1, 1, 1, 1, 19, 7, 7, 5, 5, 5 ],
	[ 1, 1, 1, 1, 1, 1, 1, 1, 10, 1, 1, 10, 5, 7, 5, 5 ],
	[ 1, 1, 1, 24, 23, 20, 10, 1, 1, 24, 1, 23, 1, 7, 5, 5 ],
	[ 10, 1, 1, 1, 1, 1, 1, 10, 1, 10, 1, 1, 1, 1, 7, 5 ],
	[ 1, 1, 10, 1, 1, 1, 1, 10, 1, 10, 21, 10, 1, 1, 21, 1 ],
	[ 1, 1, 1, 1, 1, 1, 1, 1, 1, 1, 1, 1, 1, 1, 19, 1 ],
	[ 10, 1, 10, 1, 10, 1, 10, 1, 1, 1, 1, 18, 10, 20, 1, 1 ],
	[ 1, 10, 1, 1, 1, 1, 1, 1, 10, 1, 1, 1, 1, 10, 22, 1 ],
	[ 10, 1, 1, 1, 19, 1, 10, 1, 1, 10, 20, 10, 1, 23, 1, 1 ],
	[ 1, 1, 10, 10, 1, 1, 1, 1, 20, 1, 10, 1, 1, 1, 1, 10 ],
	[ 1, 1, 10, 10, 1, 18, 1, 1, 1, 1, 1, 10, 10, 1, 1, 10 ]
],
"objects": [
	{
		"x": -768,
		"y": 1152,
		"type": "TREE_0"
	},
	{
		"x": -896,
		"y": 1024,
		"type": "TREE_0"
	},
	{
		"x": -736,
		"y": 1376,
		"type": "TREE_0"
	},
	{
		"x": -960,
		"y": 1248,
		"type": "TREE_0"
	},
	{
		"x": -672,
		"y": 1024,
		"type": "TREE_0"
	},
	{
		"x": -576,
		"y": 1376,
		"type": "TREE_0"
	},
	{
		"x": -640,
		"y": 1248,
		"type": "TREE_0"
	},
	{
		"x": -1024,
		"y": 1024,
		"type": "TREE_0"
	},
	{
		"x": -544,
		"y": 1120,
		"type": "TREE_0"
	},
	{
		"x": -576,
		"y": 1504,
		"type": "TREE_0"
	},
	{
		"x": -736,
		"y": 1504,
		"type": "TREE_1"
	},
	{
		"x": -960,
		"y": 1472,
		"type": "TREE_1"
	},
	{
		"x": -608,
		"y": 1120,
		"type": "POKEBALL"
	}
]
}