{
"x": 23,
"y": -21,
"biomeType": "HAUNTED",
"tileData": [
	[ 1, 5, 5, 5, 7, 5, 7, 7, 7, 5, 5, 5, 5, 5, 7, 5 ],
	[ 9, 5, 5, 7, 5, 5, 7, 8, 5, 5, 8, 5, 5, 5, 7, 5 ],
	[ 7, 5, 7, 7, 5, 1, 5, 5, 5, 5, 5, 7, 5, 5, 7, 5 ],
	[ 5, 5, 1, 1, 9, 5, 7, 7, 9, 9, 5, 5, 7, 5, 5, 5 ],
	[ 7, 5, 5, 5, 9, 5, 5, 7, 5, 5, 7, 8, 7, 5, 7, 5 ],
	[ 5, 9, 5, 8, 5, 7, 7, 5, 7, 7, 7, 5, 5, 7, 7, 5 ],
	[ 7, 5, 5, 5, 5, 7, 9, 5, 7, 5, 5, 5, 7, 5, 5, 5 ],
	[ 5, 1, 5, 5, 5, 5, 1, 5, 5, 5, 5, 5, 1, 7, 7, 5 ],
	[ 5, 7, 5, 8, 7, 5, 1, 5, 5, 5, 5, 5, 5, 5, 5, 5 ],
	[ 5, 5, 7, 5, 5, 5, 7, 5, 7, 7, 5, 5, 5, 8, 5, 5 ],
	[ 5, 8, 5, 9, 9, 8, 5, 5, 5, 1, 5, 5, 5, 5, 5, 7 ],
	[ 5, 7, 5, 5, 9, 5, 5, 7, 5, 5, 5, 7, 5, 5, 7, 5 ],
	[ 1, 5, 5, 5, 5, 5, 5, 8, 1, 8, 8, 5, 5, 7, 8, 5 ],
	[ 5, 5, 7, 5, 5, 7, 8, 9, 5, 5, 7, 5, 7, 5, 7, 5 ],
	[ 5, 5, 5, 5, 5, 8, 5, 5, 7, 7, 5, 5, 5, 7, 7, 8 ],
	[ 5, 5, 5, 7, 5, 9, 5, 5, 5, 7, 5, 8, 5, 8, 8, 5 ]
],
"objects": [
	{
		"x": 12032,
		"y": -10624,
		"type": "HAUNTED_TREE"
	},
	{
		"x": 11904,
		"y": -10752,
		"type": "HAUNTED_TREE"
	},
	{
		"x": 12064,
		"y": -10400,
		"type": "HAUNTED_TREE"
	},
	{
		"x": 11840,
		"y": -10528,
		"type": "HAUNTED_TREE"
	},
	{
		"x": 11872,
		"y": -10336,
		"type": "HAUNTED_TREE"
	},
	{
		"x": 12128,
		"y": -10752,
		"type": "HAUNTED_TREE"
	},
	{
		"x": 12224,
		"y": -10400,
		"type": "HAUNTED_TREE"
	},
	{
		"x": 12160,
		"y": -10528,
		"type": "HAUNTED_TREE"
	},
	{
		"x": 11776,
		"y": -10752,
		"type": "HAUNTED_TREE"
	},
	{
		"x": 12256,
		"y": -10656,
		"type": "HAUNTED_TREE"
	},
	{
		"x": 12224,
		"y": -10272,
		"type": "HAUNTED_TREE"
	},
	{
		"x": 12064,
		"y": -10272,
		"type": "HAUNTED_TREE"
	}
]
}