{
"x": 27,
"y": -21,
"biomeType": "PLAINS",
"tileData": [
	[ 1, 1, 10, 1, 1, 10, 1, 20, 10, 1, 1, 1, 1, 10, 10, 10 ],
	[ 1, 1, 10, 20, 1, 10, 20, 1, 10, 1, 1, 1, 1, 1, 10, 10 ],
	[ 10, 1, 20, 1, 1, 1, 10, 10, 18, 20, 10, 10, 1, 1, 1, 10 ],
	[ 1, 1, 10, 1, 19, 10, 1, 1, 1, 1, 10, 1, 1, 10, 10, 1 ],
	[ 1, 1, 1, 1, 10, 1, 1, 1, 1, 20, 10, 1, 10, 1, 1, 10 ],
	[ 1, 1, 1, 1, 10, 10, 21, 10, 1, 1, 10, 10, 1, 1, 1, 1 ],
	[ 18, 1, 10, 1, 1, 18, 1, 20, 21, 10, 1, 1, 1, 1, 19, 1 ],
	[ 23, 10, 1, 10, 24, 1, 1, 10, 1, 1, 1, 20, 1, 1, 20, 1 ],
	[ 1, 10, 1, 20, 1, 1, 1, 1, 1, 1, 1, 1, 10, 10, 1, 1 ],
	[ 1, 10, 1, 1, 18, 10, 1, 10, 1, 1, 20, 1, 19, 10, 10, 1 ],
	[ 1, 1, 1, 10, 1, 1, 1, 1, 1, 1, 1, 1, 1, 10, 1, 1 ],
	[ 1, 18, 22, 1, 1, 1, 1, 1, 1, 20, 1, 1, 10, 22, 22, 10 ],
	[ 10, 10, 22, 1, 1, 1, 1, 10, 20, 1, 1, 10, 1, 1, 22, 10 ],
	[ 1, 1, 1, 1, 10, 1, 1, 10, 1, 10, 10, 23, 1, 10, 24, 1 ],
	[ 20, 1, 10, 24, 10, 10, 21, 21, 10, 1, 1, 19, 1, 21, 10, 1 ],
	[ 1, 1, 1, 1, 1, 1, 1, 1, 10, 10, 1, 10, 10, 1, 1, 1 ]
],
"objects": [
	{
		"x": 14080,
		"y": -10624,
		"type": "TREE_0"
	},
	{
		"x": 13952,
		"y": -10752,
		"type": "TREE_0"
	},
	{
		"x": 14112,
		"y": -10400,
		"type": "TREE_0"
	},
	{
		"x": 13888,
		"y": -10528,
		"type": "TREE_0"
	},
	{
		"x": 13920,
		"y": -10336,
		"type": "TREE_0"
	},
	{
		"x": 14176,
		"y": -10752,
		"type": "TREE_0"
	},
	{
		"x": 14272,
		"y": -10400,
		"type": "TREE_0"
	},
	{
		"x": 14208,
		"y": -10528,
		"type": "TREE_0"
	},
	{
		"x": 13824,
		"y": -10752,
		"type": "TREE_0"
	},
	{
		"x": 14304,
		"y": -10656,
		"type": "TREE_0"
	},
	{
		"x": 14272,
		"y": -10272,
		"type": "TREE_0"
	},
	{
		"x": 14112,
		"y": -10272,
		"type": "TREE_1"
	}
]
}