{
"x": -2,
"y": 1,
"biomeType": "PLAINS",
"tileData": [
	[ 1, 10, 1, 10, 20, 1, 1, 1, 1, 1, 1, 1, 10, 10, 1, 1 ],
	[ 10, 1, 1, 24, 1, 1, 1, 10, 1, 1, 1, 1, 10, 10, 20, 1 ],
	[ 1, 10, 10, 1, 1, 1, 1, 1, 10, 1, 1, 1, 20, 1, 1, 1 ],
	[ 10, 10, 1, 1, 10, 10, 1, 10, 1, 19, 10, 23, 18, 1, 10, 10 ],
	[ 1, 1, 20, 10, 20, 1, 10, 10, 1, 1, 1, 1, 1, 1, 1, 1 ],
	[ 1, 1, 1, 1, 1, 1, 1, 10, 10, 10, 1, 1, 1, 1, 20, 1 ],
	[ 1, 1, 18, 1, 1, 1, 1, 1, 1, 1, 1, 20, 1, 1, 1, 1 ],
	[ 19, 1, 1, 10, 1, 1, 1, 21, 19, 1, 1, 1, 1, 1, 1, 10 ],
	[ 1, 1, 7, 18, 1, 10, 1, 1, 1, 1, 1, 1, 1, 1, 1, 1 ],
	[ 1, 1, 9, 1, 8, 1, 1, 1, 1, 10, 10, 1, 1, 10, 1, 10 ],
	[ 5, 5, 9, 5, 7, 5, 5, 10, 1, 22, 18, 1, 10, 1, 18, 18 ],
	[ 8, 5, 5, 9, 7, 5, 5, 5, 1, 1, 1, 1, 1, 1, 23, 10 ],
	[ 5, 5, 5, 5, 5, 8, 1, 5, 1, 21, 10, 1, 18, 1, 1, 1 ],
	[ 8, 7, 5, 5, 7, 8, 7, 7, 10, 5, 1, 10, 10, 1, 1, 24 ],
	[ 5, 7, 5, 5, 1, 7, 7, 7, 7, 5, 1, 1, 20, 1, 1, 1 ],
	[ 5, 5, 5, 5, 5, 5, 7, 7, 5, 7, 10, 1, 1, 1, 1, 1 ]
],
"objects": [
	{
		"x": -768,
		"y": 640,
		"type": "TREE_0"
	},
	{
		"x": -896,
		"y": 512,
		"type": "TREE_0"
	},
	{
		"x": -736,
		"y": 864,
		"type": "TREE_0"
	},
	{
		"x": -960,
		"y": 736,
		"type": "TREE_0"
	},
	{
		"x": -928,
		"y": 928,
		"type": "TREE_0"
	},
	{
		"x": -576,
		"y": 864,
		"type": "TREE_0"
	},
	{
		"x": -1024,
		"y": 512,
		"type": "TREE_0"
	},
	{
		"x": -576,
		"y": 992,
		"type": "TREE_0"
	},
	{
		"x": -576,
		"y": 640,
		"type": "TREE_0"
	},
	{
		"x": -736,
		"y": 992,
		"type": "TREE_1"
	},
	{
		"x": -960,
		"y": 608,
		"type": "POKEBALL"
	}
]
}