{
"x": 23,
"y": -17,
"biomeType": "HAUNTED",
"tileData": [
	[ 5, 5, 7, 7, 5, 8, 7, 7, 5, 5, 7, 5, 5, 5, 7, 7 ],
	[ 7, 5, 5, 5, 5, 5, 5, 5, 7, 7, 7, 5, 5, 7, 5, 7 ],
	[ 5, 7, 9, 7, 5, 9, 5, 7, 5, 7, 1, 7, 8, 5, 5, 7 ],
	[ 8, 5, 5, 5, 7, 5, 7, 7, 5, 5, 5, 8, 5, 5, 5, 5 ],
	[ 5, 5, 9, 5, 7, 5, 5, 5, 7, 5, 7, 5, 7, 5, 5, 5 ],
	[ 5, 5, 5, 7, 5, 5, 5, 7, 5, 5, 7, 5, 5, 5, 7, 5 ],
	[ 7, 5, 5, 7, 7, 5, 5, 5, 7, 5, 7, 7, 7, 5, 5, 1 ],
	[ 5, 5, 7, 7, 5, 5, 8, 7, 5, 7, 5, 5, 7, 5, 7, 7 ],
	[ 7, 5, 7, 7, 7, 1, 5, 5, 7, 5, 7, 5, 5, 5, 5, 7 ],
	[ 5, 8, 5, 5, 5, 7, 7, 7, 7, 8, 7, 7, 5, 7, 5, 7 ],
	[ 5, 5, 5, 8, 7, 5, 5, 5, 5, 5, 8, 5, 5, 5, 8, 7 ],
	[ 8, 5, 8, 5, 7, 5, 5, 7, 5, 7, 7, 5, 5, 5, 7, 5 ],
	[ 5, 8, 9, 5, 5, 7, 5, 5, 8, 7, 7, 7, 5, 5, 5, 5 ],
	[ 7, 5, 5, 5, 8, 5, 7, 1, 5, 5, 5, 5, 5, 5, 7, 8 ],
	[ 7, 7, 7, 5, 5, 1, 7, 7, 5, 5, 8, 7, 8, 5, 5, 5 ],
	[ 5, 7, 8, 7, 7, 7, 5, 5, 7, 5, 7, 5, 5, 9, 5, 7 ]
],
"objects": [
	{
		"x": 12032,
		"y": -8576,
		"type": "HAUNTED_TREE"
	},
	{
		"x": 11904,
		"y": -8704,
		"type": "HAUNTED_TREE"
	},
	{
		"x": 12064,
		"y": -8352,
		"type": "HAUNTED_TREE"
	},
	{
		"x": 11840,
		"y": -8480,
		"type": "HAUNTED_TREE"
	},
	{
		"x": 11872,
		"y": -8288,
		"type": "HAUNTED_TREE"
	},
	{
		"x": 12128,
		"y": -8704,
		"type": "HAUNTED_TREE"
	},
	{
		"x": 12224,
		"y": -8352,
		"type": "HAUNTED_TREE"
	},
	{
		"x": 12160,
		"y": -8480,
		"type": "HAUNTED_TREE"
	},
	{
		"x": 11776,
		"y": -8704,
		"type": "HAUNTED_TREE"
	},
	{
		"x": 12256,
		"y": -8608,
		"type": "HAUNTED_TREE"
	},
	{
		"x": 12224,
		"y": -8224,
		"type": "HAUNTED_TREE"
	},
	{
		"x": 12064,
		"y": -8224,
		"type": "HAUNTED_TREE"
	}
]
}