{
"x": 25,
"y": -21,
"biomeType": "HAUNTED",
"tileData": [
	[ 5, 5, 5, 7, 5, 5, 5, 7, 7, 5, 5, 7, 5, 7, 5, 8 ],
	[ 17, 8, 5, 7, 5, 5, 7, 5, 5, 7, 8, 5, 15, 17, 15, 15 ],
	[ 15, 15, 15, 15, 15, 16, 15, 15, 17, 2, 15, 15, 16, 16, 16, 17 ],
	[ 15, 16, 15, 15, 15, 2, 15, 15, 16, 16, 15, 15, 16, 15, 2, 15 ],
	[ 15, 15, 15, 15, 15, 15, 2, 16, 15, 15, 16, 17, 16, 15, 15, 15 ],
	[ 15, 15, 15, 15, 15, 17, 15, 15, 15, 15, 15, 15, 16, 16, 15, 15 ],
	[ 15, 15, 15, 15, 15, 2, 15, 15, 17, 2, 15, 16, 15, 15, 15, 15 ],
	[ 15, 15, 15, 16, 15, 15, 5, 5, 7, 7, 5, 7, 15, 15, 15, 15 ],
	[ 15, 15, 15, 16, 15, 5, 5, 1, 5, 7, 5, 5, 5, 16, 15, 15 ],
	[ 15, 15, 15, 15, 5, 7, 8, 5, 5, 7, 7, 5, 5, 7, 7, 2 ],
	[ 15, 16, 15, 15, 5, 7, 5, 5, 5, 5, 7, 8, 7, 5, 5, 1 ],
	[ 15, 15, 15, 15, 7, 7, 5, 7, 7, 5, 9, 5, 5, 1, 7, 5 ],
	[ 15, 15, 17, 17, 16, 16, 7, 5, 5, 5, 9, 5, 5, 5, 5, 7 ],
	[ 15, 15, 2, 15, 15, 16, 15, 15, 17, 5, 7, 5, 7, 5, 15, 16 ],
	[ 16, 15, 17, 15, 16, 15, 15, 16, 16, 15, 16, 17, 15, 15, 15, 15 ],
	[ 16, 15, 15, 15, 15, 16, 15, 15, 15, 17, 15, 15, 15, 16, 15, 15 ]
],
"objects": [
	{
		"x": 13088,
		"y": -10400,
		"type": "HAUNTED_TREE"
	},
	{
		"x": 13120,
		"y": -10592,
		"type": "HAUNTED_TREE"
	},
	{
		"x": 12832,
		"y": -10592,
		"type": "HAUNTED_TREE"
	},
	{
		"x": 12800,
		"y": -10272,
		"type": "HAUNTED_TREE"
	},
	{
		"x": 12800,
		"y": -10752,
		"type": "HAUNTED_TREE"
	},
	{
		"x": 12800,
		"y": -10400,
		"type": "HAUNTED_TREE"
	},
	{
		"x": 13216,
		"y": -10464,
		"type": "HAUNTED_TREE"
	},
	{
		"x": 13152,
		"y": -10272,
		"type": "HAUNTED_TREE"
	}
]
}