{
"x": 24,
"y": -23,
"biomeType": "HAUNTED",
"tileData": [
	[ 5, 5, 5, 8, 5, 5, 7, 9, 8, 5, 7, 5, 5, 7, 7, 5 ],
	[ 7, 7, 5, 5, 5, 5, 1, 7, 1, 5, 5, 5, 5, 5, 9, 7 ],
	[ 8, 5, 5, 5, 5, 7, 5, 7, 5, 7, 5, 5, 7, 1, 7, 5 ],
	[ 5, 5, 5, 8, 7, 5, 5, 5, 5, 5, 5, 9, 7, 5, 8, 5 ],
	[ 5, 5, 5, 5, 7, 7, 9, 7, 5, 7, 5, 7, 8, 5, 5, 5 ],
	[ 5, 5, 5, 5, 7, 5, 5, 7, 7, 5, 8, 5, 5, 5, 5, 5 ],
	[ 5, 8, 5, 5, 5, 5, 5, 5, 5, 7, 8, 7, 5, 5, 7, 9 ],
	[ 5, 5, 7, 5, 5, 7, 5, 5, 5, 5, 7, 5, 7, 5, 8, 7 ],
	[ 5, 5, 7, 7, 5, 5, 5, 7, 5, 5, 5, 5, 5, 5, 5, 5 ],
	[ 5, 5, 5, 5, 5, 5, 7, 5, 8, 7, 5, 5, 5, 7, 5, 1 ],
	[ 9, 7, 5, 7, 9, 5, 5, 8, 5, 5, 5, 5, 7, 8, 7, 5 ],
	[ 5, 5, 16, 15, 2, 15, 15, 15, 15, 7, 9, 7, 5, 9, 5, 5 ],
	[ 15, 15, 15, 15, 15, 15, 16, 15, 16, 15, 15, 5, 5, 5, 5, 7 ],
	[ 16, 16, 15, 17, 15, 16, 15, 16, 16, 15, 15, 16, 15, 15, 5, 9 ],
	[ 16, 16, 15, 15, 15, 15, 16, 16, 15, 15, 15, 15, 15, 15, 17, 15 ],
	[ 16, 15, 15, 16, 15, 15, 15, 15, 16, 17, 15, 15, 15, 15, 15, 15 ]
],
"objects": [
	{
		"x": 12544,
		"y": -11648,
		"type": "HAUNTED_TREE"
	},
	{
		"x": 12416,
		"y": -11776,
		"type": "HAUNTED_TREE"
	},
	{
		"x": 12576,
		"y": -11424,
		"type": "HAUNTED_TREE"
	},
	{
		"x": 12352,
		"y": -11552,
		"type": "HAUNTED_TREE"
	},
	{
		"x": 12384,
		"y": -11360,
		"type": "HAUNTED_TREE"
	},
	{
		"x": 12640,
		"y": -11776,
		"type": "HAUNTED_TREE"
	},
	{
		"x": 12704,
		"y": -11328,
		"type": "HAUNTED_TREE"
	},
	{
		"x": 12288,
		"y": -11776,
		"type": "HAUNTED_TREE"
	},
	{
		"x": 12576,
		"y": -11296,
		"type": "HAUNTED_TREE"
	}
]
}