{
"x": 1,
"y": -4,
"biomeType": "FOREST",
"tileData": [
	[ 12, 11, 20, 11, 11, 10, 11, 11, 11, 12, 11, 12, 11, 11, 11, 11 ],
	[ 11, 11, 10, 1, 11, 11, 11, 12, 11, 11, 11, 12, 11, 11, 1, 12 ],
	[ 10, 12, 11, 10, 11, 11, 1, 12, 11, 12, 12, 11, 11, 1, 11, 10 ],
	[ 11, 11, 11, 11, 11, 11, 11, 11, 1, 10, 11, 11, 11, 10, 12, 11 ],
	[ 12, 10, 11, 11, 12, 11, 11, 1, 11, 11, 10, 12, 11, 12, 1, 11 ],
	[ 12, 11, 11, 11, 11, 11, 12, 11, 11, 11, 12, 12, 11, 11, 11, 11 ],
	[ 11, 12, 1, 11, 11, 11, 11, 11, 11, 10, 11, 11, 11, 11, 11, 11 ],
	[ 12, 11, 12, 11, 11, 10, 11, 11, 11, 11, 10, 11, 12, 11, 11, 20 ],
	[ 1, 10, 1, 11, 10, 11, 11, 11, 11, 11, 11, 11, 11, 11, 1, 12 ],
	[ 12, 11, 11, 12, 11, 11, 1, 11, 11, 1, 11, 11, 11, 11, 11, 11 ],
	[ 12, 12, 12, 11, 11, 11, 11, 20, 12, 11, 11, 10, 12, 11, 11, 1 ],
	[ 11, 12, 11, 11, 11, 10, 12, 1, 11, 11, 12, 20, 11, 10, 12, 11 ],
	[ 11, 11, 11, 11, 11, 11, 12, 10, 11, 11, 12, 11, 10, 20, 10, 11 ],
	[ 11, 11, 1, 11, 11, 11, 1, 11, 11, 10, 12, 11, 11, 12, 11, 12 ],
	[ 11, 1, 11, 11, 11, 11, 11, 11, 12, 11, 11, 1, 11, 11, 12, 1 ],
	[ 12, 11, 11, 11, 1, 11, 10, 1, 12, 11, 12, 12, 11, 10, 11, 20 ]
],
"objects": [
	{
		"x": 768,
		"y": -1920,
		"type": "TREE_0"
	},
	{
		"x": 640,
		"y": -2048,
		"type": "TREE_0"
	},
	{
		"x": 800,
		"y": -1696,
		"type": "TREE_0"
	},
	{
		"x": 576,
		"y": -1824,
		"type": "TREE_0"
	},
	{
		"x": 608,
		"y": -1632,
		"type": "TREE_0"
	},
	{
		"x": 864,
		"y": -2048,
		"type": "TREE_0"
	},
	{
		"x": 960,
		"y": -1696,
		"type": "TREE_0"
	},
	{
		"x": 896,
		"y": -1824,
		"type": "TREE_0"
	},
	{
		"x": 512,
		"y": -2048,
		"type": "TREE_0"
	},
	{
		"x": 992,
		"y": -1952,
		"type": "TREE_0"
	},
	{
		"x": 960,
		"y": -1568,
		"type": "TREE_0"
	},
	{
		"x": 800,
		"y": -1568,
		"type": "TREE_1"
	}
]
}