{
"x": 23,
"y": -23,
"biomeType": "HAUNTED",
"tileData": [
	[ 5, 7, 1, 7, 5, 5, 5, 5, 7, 9, 9, 5, 1, 5, 5, 7 ],
	[ 5, 7, 7, 5, 7, 5, 5, 5, 5, 5, 5, 5, 7, 5, 5, 7 ],
	[ 7, 5, 7, 5, 5, 5, 5, 8, 7, 5, 5, 5, 5, 5, 5, 8 ],
	[ 1, 1, 5, 7, 5, 5, 5, 7, 8, 5, 5, 5, 5, 7, 7, 5 ],
	[ 1, 5, 5, 5, 5, 5, 7, 5, 5, 8, 5, 5, 7, 5, 1, 5 ],
	[ 5, 7, 5, 5, 5, 5, 5, 7, 5, 5, 5, 8, 5, 5, 5, 5 ],
	[ 7, 5, 7, 7, 8, 7, 7, 5, 5, 5, 1, 5, 7, 8, 5, 5 ],
	[ 5, 5, 5, 7, 5, 9, 5, 5, 5, 5, 5, 7, 5, 5, 5, 5 ],
	[ 7, 5, 5, 5, 5, 8, 5, 7, 5, 5, 1, 5, 7, 5, 7, 5 ],
	[ 5, 5, 7, 7, 7, 5, 7, 8, 5, 7, 9, 5, 5, 5, 5, 5 ],
	[ 5, 5, 5, 7, 5, 5, 7, 5, 7, 5, 5, 5, 5, 5, 5, 7 ],
	[ 7, 7, 5, 5, 7, 9, 8, 5, 9, 5, 5, 8, 9, 7, 5, 5 ],
	[ 7, 7, 5, 5, 1, 5, 5, 5, 7, 5, 8, 9, 5, 5, 5, 5 ],
	[ 5, 5, 7, 7, 7, 5, 7, 5, 5, 5, 8, 9, 5, 5, 7, 5 ],
	[ 5, 7, 1, 7, 8, 5, 5, 5, 5, 7, 7, 8, 5, 5, 5, 5 ],
	[ 5, 5, 7, 5, 8, 7, 5, 5, 5, 1, 5, 7, 7, 5, 5, 9 ]
],
"objects": [
	{
		"x": 12032,
		"y": -11648,
		"type": "HAUNTED_TREE"
	},
	{
		"x": 11904,
		"y": -11776,
		"type": "HAUNTED_TREE"
	},
	{
		"x": 12064,
		"y": -11424,
		"type": "HAUNTED_TREE"
	},
	{
		"x": 11840,
		"y": -11552,
		"type": "HAUNTED_TREE"
	},
	{
		"x": 11872,
		"y": -11360,
		"type": "HAUNTED_TREE"
	},
	{
		"x": 12128,
		"y": -11776,
		"type": "HAUNTED_TREE"
	},
	{
		"x": 12224,
		"y": -11424,
		"type": "HAUNTED_TREE"
	},
	{
		"x": 12160,
		"y": -11552,
		"type": "HAUNTED_TREE"
	},
	{
		"x": 11776,
		"y": -11776,
		"type": "HAUNTED_TREE"
	},
	{
		"x": 12256,
		"y": -11680,
		"type": "HAUNTED_TREE"
	},
	{
		"x": 12224,
		"y": -11296,
		"type": "HAUNTED_TREE"
	},
	{
		"x": 12064,
		"y": -11296,
		"type": "HAUNTED_TREE"
	}
]
}