{
"x": 27,
"y": -22,
"biomeType": "PLAINS",
"tileData": [
	[ 15, 17, 15, 15, 15, 16, 15, 15, 15, 16, 10, 1, 1, 10, 10, 10 ],
	[ 8, 9, 5, 15, 15, 2, 15, 16, 16, 15, 1, 1, 1, 1, 1, 20 ],
	[ 5, 7, 5, 8, 15, 15, 16, 15, 15, 15, 1, 10, 1, 10, 1, 1 ],
	[ 5, 5, 5, 5, 5, 15, 15, 15, 15, 1, 10, 1, 20, 10, 10, 1 ],
	[ 5, 5, 8, 8, 5, 1, 15, 15, 15, 22, 1, 1, 1, 1, 1, 10 ],
	[ 8, 8, 5, 7, 5, 7, 10, 15, 15, 1, 1, 1, 10, 1, 1, 1 ],
	[ 7, 5, 7, 5, 5, 5, 19, 18, 15, 10, 19, 1, 1, 1, 1, 1 ],
	[ 5, 7, 5, 7, 5, 5, 5, 18, 1, 15, 1, 1, 1, 1, 1, 10 ],
	[ 8, 8, 5, 5, 5, 5, 5, 23, 1, 10, 1, 20, 22, 22, 10, 1 ],
	[ 7, 7, 5, 5, 5, 7, 7, 1, 1, 1, 1, 24, 1, 1, 10, 1 ],
	[ 7, 7, 8, 9, 8, 1, 9, 5, 1, 1, 1, 10, 10, 10, 1, 10 ],
	[ 5, 5, 9, 5, 5, 5, 5, 5, 10, 1, 21, 1, 22, 1, 10, 22 ],
	[ 5, 5, 5, 7, 7, 5, 7, 1, 1, 1, 10, 1, 1, 1, 1, 1 ],
	[ 7, 9, 8, 8, 7, 5, 5, 1, 5, 10, 1, 1, 1, 1, 1, 1 ],
	[ 5, 7, 5, 5, 5, 1, 8, 5, 5, 18, 10, 1, 1, 22, 1, 1 ],
	[ 7, 7, 5, 5, 7, 8, 9, 5, 1, 1, 1, 1, 20, 1, 10, 1 ]
],
"objects": [
	{
		"x": 13888,
		"y": -11040,
		"type": "CACTUS"
	},
	{
		"x": 13856,
		"y": -11104,
		"type": "CACTUS"
	},
	{
		"x": 13824,
		"y": -11264,
		"type": "CACTUS"
	},
	{
		"x": 13824,
		"y": -11168,
		"type": "CACTUS"
	},
	{
		"x": 13984,
		"y": -11008,
		"type": "CACTUS"
	},
	{
		"x": 13888,
		"y": -10976,
		"type": "CACTUS"
	},
	{
		"x": 13824,
		"y": -11008,
		"type": "DEAD_TREE"
	},
	{
		"x": 13952,
		"y": -11072,
		"type": "DEAD_TREE"
	}
]
}