{
"x": 25,
"y": -20,
"biomeType": "DESERT",
"tileData": [
	[ 7, 15, 5, 5, 5, 7, 5, 7, 7, 5, 5, 5, 5, 5, 5, 7 ],
	[ 15, 15, 15, 15, 15, 17, 7, 5, 8, 7, 7, 5, 5, 7, 5, 9 ],
	[ 15, 15, 16, 15, 15, 16, 17, 7, 5, 5, 5, 9, 5, 9, 5, 5 ],
	[ 15, 15, 15, 15, 15, 2, 15, 15, 7, 7, 5, 5, 8, 5, 5, 7 ],
	[ 15, 15, 16, 16, 15, 2, 15, 15, 5, 5, 5, 5, 7, 7, 7, 8 ],
	[ 15, 16, 17, 17, 16, 16, 15, 15, 15, 7, 5, 5, 5, 5, 5, 7 ],
	[ 15, 15, 15, 2, 15, 15, 15, 16, 15, 7, 5, 5, 5, 5, 7, 5 ],
	[ 15, 17, 15, 15, 15, 15, 2, 15, 15, 5, 5, 7, 5, 5, 5, 5 ],
	[ 15, 16, 15, 15, 16, 16, 15, 15, 15, 5, 5, 5, 5, 7, 8, 5 ],
	[ 16, 15, 15, 15, 15, 15, 15, 15, 15, 5, 7, 8, 8, 5, 7, 5 ],
	[ 15, 15, 15, 15, 15, 15, 16, 15, 7, 5, 5, 5, 5, 5, 5, 7 ],
	[ 15, 15, 2, 15, 15, 15, 15, 15, 7, 7, 1, 5, 9, 5, 5, 5 ],
	[ 15, 2, 15, 16, 15, 15, 15, 7, 1, 5, 1, 5, 5, 5, 5, 5 ],
	[ 16, 15, 15, 15, 15, 15, 15, 5, 1, 5, 1, 5, 7, 9, 5, 7 ],
	[ 15, 15, 15, 15, 15, 17, 15, 15, 5, 5, 5, 5, 5, 7, 5, 7 ],
	[ 15, 16, 15, 15, 15, 15, 15, 16, 8, 5, 7, 7, 7, 5, 5, 5 ]
],
"objects": [
	{
		"x": 13088,
		"y": -9888,
		"type": "HAUNTED_TREE"
	},
	{
		"x": 12864,
		"y": -10016,
		"type": "HAUNTED_TREE"
	},
	{
		"x": 12896,
		"y": -9824,
		"type": "HAUNTED_TREE"
	},
	{
		"x": 13248,
		"y": -9888,
		"type": "HAUNTED_TREE"
	},
	{
		"x": 13184,
		"y": -10016,
		"type": "HAUNTED_TREE"
	},
	{
		"x": 12800,
		"y": -10240,
		"type": "HAUNTED_TREE"
	},
	{
		"x": 13248,
		"y": -9760,
		"type": "HAUNTED_TREE"
	},
	{
		"x": 13088,
		"y": -9760,
		"type": "HAUNTED_TREE"
	}
]
}