{
"x": 24,
"y": -20,
"biomeType": "HAUNTED",
"tileData": [
	[ 5, 5, 1, 5, 5, 5, 5, 5, 8, 5, 7, 5, 7, 5, 5, 5 ],
	[ 5, 8, 7, 5, 5, 5, 5, 5, 7, 5, 1, 5, 5, 5, 8, 5 ],
	[ 5, 5, 7, 5, 5, 5, 7, 7, 5, 8, 5, 5, 5, 8, 8, 7 ],
	[ 7, 7, 5, 5, 9, 9, 5, 8, 1, 5, 5, 5, 5, 5, 5, 5 ],
	[ 5, 5, 7, 5, 5, 5, 8, 8, 7, 5, 5, 1, 5, 7, 5, 5 ],
	[ 5, 5, 7, 5, 5, 5, 5, 7, 5, 7, 5, 5, 8, 8, 5, 5 ],
	[ 5, 7, 9, 5, 5, 7, 7, 7, 7, 7, 8, 5, 7, 5, 5, 5 ],
	[ 5, 5, 7, 5, 7, 5, 5, 7, 5, 7, 5, 5, 7, 5, 5, 1 ],
	[ 7, 5, 7, 8, 5, 5, 5, 5, 5, 5, 5, 5, 5, 5, 5, 9 ],
	[ 5, 5, 5, 5, 5, 7, 5, 5, 8, 1, 5, 5, 5, 7, 5, 9 ],
	[ 5, 5, 5, 5, 8, 5, 7, 5, 8, 5, 5, 5, 7, 5, 5, 7 ],
	[ 5, 5, 5, 5, 5, 5, 8, 7, 7, 5, 5, 5, 5, 5, 5, 5 ],
	[ 5, 5, 5, 5, 5, 7, 8, 5, 5, 7, 7, 1, 7, 5, 5, 5 ],
	[ 5, 5, 5, 5, 7, 5, 5, 5, 5, 5, 5, 7, 8, 5, 5, 7 ],
	[ 7, 5, 7, 1, 9, 5, 7, 5, 5, 5, 5, 7, 7, 7, 5, 5 ],
	[ 5, 5, 5, 7, 5, 5, 7, 5, 7, 7, 5, 7, 5, 5, 5, 5 ]
],
"objects": [
	{
		"x": 12544,
		"y": -10112,
		"type": "HAUNTED_TREE"
	},
	{
		"x": 12416,
		"y": -10240,
		"type": "HAUNTED_TREE"
	},
	{
		"x": 12576,
		"y": -9888,
		"type": "HAUNTED_TREE"
	},
	{
		"x": 12352,
		"y": -10016,
		"type": "HAUNTED_TREE"
	},
	{
		"x": 12384,
		"y": -9824,
		"type": "HAUNTED_TREE"
	},
	{
		"x": 12640,
		"y": -10240,
		"type": "HAUNTED_TREE"
	},
	{
		"x": 12736,
		"y": -9888,
		"type": "HAUNTED_TREE"
	},
	{
		"x": 12672,
		"y": -10016,
		"type": "HAUNTED_TREE"
	},
	{
		"x": 12288,
		"y": -10240,
		"type": "HAUNTED_TREE"
	},
	{
		"x": 12768,
		"y": -10144,
		"type": "HAUNTED_TREE"
	},
	{
		"x": 12736,
		"y": -9760,
		"type": "HAUNTED_TREE"
	},
	{
		"x": 12576,
		"y": -9760,
		"type": "HAUNTED_TREE"
	}
]
}