{
"x": 25,
"y": -19,
"biomeType": "HAUNTED",
"tileData": [
	[ 5, 5, 5, 1, 7, 5, 5, 8, 5, 7, 9, 5, 5, 1, 7, 5 ],
	[ 7, 5, 5, 5, 5, 7, 5, 5, 5, 5, 5, 5, 5, 5, 7, 7 ],
	[ 5, 5, 5, 7, 5, 7, 5, 5, 5, 5, 1, 7, 7, 7, 5, 7 ],
	[ 8, 8, 5, 7, 9, 7, 7, 5, 5, 5, 9, 5, 5, 5, 5, 5 ],
	[ 5, 5, 5, 7, 5, 7, 5, 5, 7, 5, 7, 5, 5, 1, 8, 5 ],
	[ 5, 5, 5, 5, 5, 7, 9, 5, 8, 7, 7, 7, 5, 5, 7, 8 ],
	[ 7, 7, 5, 5, 5, 5, 8, 7, 5, 5, 5, 5, 1, 9, 7, 7 ],
	[ 8, 7, 7, 7, 5, 5, 5, 7, 5, 5, 8, 7, 5, 7, 8, 5 ],
	[ 7, 7, 5, 5, 5, 7, 5, 5, 5, 7, 5, 7, 9, 1, 5, 5 ],
	[ 7, 7, 7, 5, 5, 5, 5, 5, 7, 7, 7, 7, 5, 7, 7, 7 ],
	[ 5, 9, 5, 5, 5, 7, 5, 1, 5, 7, 5, 8, 5, 7, 7, 5 ],
	[ 8, 5, 9, 5, 7, 5, 5, 7, 5, 7, 9, 5, 5, 5, 5, 5 ],
	[ 9, 8, 5, 5, 5, 7, 5, 5, 7, 5, 7, 5, 5, 9, 1, 9 ],
	[ 5, 7, 5, 5, 7, 7, 9, 5, 7, 5, 5, 5, 5, 5, 5, 7 ],
	[ 5, 5, 5, 7, 8, 7, 5, 9, 5, 5, 7, 1, 5, 5, 5, 5 ],
	[ 5, 7, 5, 5, 7, 8, 5, 5, 7, 5, 9, 5, 8, 5, 5, 5 ]
],
"objects": [
	{
		"x": 13056,
		"y": -9600,
		"type": "HAUNTED_TREE"
	},
	{
		"x": 12928,
		"y": -9728,
		"type": "HAUNTED_TREE"
	},
	{
		"x": 13088,
		"y": -9376,
		"type": "HAUNTED_TREE"
	},
	{
		"x": 12864,
		"y": -9504,
		"type": "HAUNTED_TREE"
	},
	{
		"x": 12896,
		"y": -9312,
		"type": "HAUNTED_TREE"
	},
	{
		"x": 13152,
		"y": -9728,
		"type": "HAUNTED_TREE"
	},
	{
		"x": 13248,
		"y": -9376,
		"type": "HAUNTED_TREE"
	},
	{
		"x": 13184,
		"y": -9504,
		"type": "HAUNTED_TREE"
	},
	{
		"x": 12800,
		"y": -9728,
		"type": "HAUNTED_TREE"
	},
	{
		"x": 13280,
		"y": -9632,
		"type": "HAUNTED_TREE"
	},
	{
		"x": 13248,
		"y": -9248,
		"type": "HAUNTED_TREE"
	},
	{
		"x": 13088,
		"y": -9248,
		"type": "HAUNTED_TREE"
	}
]
}