{
"x": 2,
"y": -2,
"biomeType": "FOREST",
"tileData": [
	[ 11, 11, 11, 11, 11, 11, 11, 11, 12, 12, 11, 1, 10, 11, 11, 11 ],
	[ 12, 1, 11, 1, 11, 11, 11, 12, 1, 1, 11, 12, 11, 11, 12, 10 ],
	[ 1, 11, 1, 11, 12, 11, 10, 12, 10, 1, 11, 11, 11, 10, 12, 12 ],
	[ 11, 1, 11, 11, 11, 10, 11, 10, 12, 12, 11, 11, 11, 1, 12, 11 ],
	[ 11, 20, 11, 11, 11, 11, 11, 1, 12, 10, 11, 10, 20, 11, 11, 11 ],
	[ 1, 11, 11, 12, 11, 1, 11, 12, 12, 11, 12, 11, 11, 10, 1, 12 ],
	[ 11, 11, 12, 1, 11, 11, 12, 11, 11, 11, 11, 11, 1, 10, 11, 11 ],
	[ 11, 11, 12, 11, 11, 1, 11, 11, 11, 12, 11, 11, 10, 11, 11, 12 ],
	[ 12, 11, 1, 10, 11, 11, 11, 11, 1, 11, 10, 1, 11, 11, 1, 12 ],
	[ 12, 11, 11, 10, 10, 11, 11, 1, 11, 11, 1, 11, 11, 12, 1, 11 ],
	[ 11, 11, 20, 11, 11, 11, 11, 11, 12, 12, 11, 11, 12, 12, 10, 11 ],
	[ 11, 11, 11, 11, 11, 11, 11, 12, 12, 11, 11, 11, 12, 10, 11, 12 ],
	[ 11, 11, 11, 11, 1, 11, 11, 12, 12, 11, 12, 11, 11, 12, 11, 11 ],
	[ 11, 11, 11, 12, 1, 1, 11, 11, 11, 12, 12, 11, 11, 12, 11, 11 ],
	[ 11, 12, 1, 12, 20, 11, 12, 11, 11, 11, 11, 11, 11, 11, 11, 11 ],
	[ 11, 11, 11, 11, 12, 12, 11, 1, 12, 12, 11, 11, 1, 11, 12, 11 ]
],
"objects": [
	{
		"x": 1280,
		"y": -896,
		"type": "TREE_0"
	},
	{
		"x": 1152,
		"y": -1024,
		"type": "TREE_0"
	},
	{
		"x": 1312,
		"y": -672,
		"type": "TREE_0"
	},
	{
		"x": 1088,
		"y": -800,
		"type": "TREE_0"
	},
	{
		"x": 1120,
		"y": -608,
		"type": "TREE_0"
	},
	{
		"x": 1376,
		"y": -1024,
		"type": "TREE_0"
	},
	{
		"x": 1472,
		"y": -672,
		"type": "TREE_0"
	},
	{
		"x": 1408,
		"y": -800,
		"type": "TREE_0"
	},
	{
		"x": 1024,
		"y": -1024,
		"type": "TREE_0"
	},
	{
		"x": 1504,
		"y": -928,
		"type": "TREE_0"
	},
	{
		"x": 1472,
		"y": -544,
		"type": "TREE_0"
	},
	{
		"x": 1312,
		"y": -544,
		"type": "TREE_1"
	},
	{
		"x": 1504,
		"y": -800,
		"type": "POKEBALL"
	}
]
}