{
"x": 26,
"y": -17,
"biomeType": "PLAINS",
"tileData": [
	[ 5, 7, 5, 5, 5, 5, 5, 5, 5, 5, 5, 7, 5, 10, 1, 1 ],
	[ 5, 5, 5, 5, 5, 7, 5, 8, 5, 7, 7, 5, 1, 1, 1, 1 ],
	[ 5, 7, 8, 5, 9, 7, 5, 5, 5, 1, 1, 1, 23, 19, 1, 10 ],
	[ 5, 5, 7, 5, 5, 1, 5, 7, 5, 8, 5, 10, 1, 1, 10, 1 ],
	[ 5, 5, 5, 9, 5, 7, 5, 5, 5, 7, 1, 18, 10, 10, 21, 18 ],
	[ 5, 7, 7, 5, 5, 7, 8, 1, 8, 1, 18, 1, 1, 19, 1, 19 ],
	[ 5, 5, 5, 5, 5, 5, 1, 7, 1, 1, 1, 1, 23, 1, 1, 1 ],
	[ 9, 8, 5, 7, 7, 5, 5, 5, 18, 1, 1, 1, 19, 1, 1, 1 ],
	[ 5, 5, 5, 5, 5, 8, 8, 1, 1, 1, 1, 1, 1, 19, 10, 1 ],
	[ 5, 5, 1, 1, 1, 1, 1, 1, 10, 22, 10, 1, 10, 18, 1, 10 ],
	[ 5, 9, 7, 5, 8, 1, 1, 18, 1, 1, 22, 10, 1, 1, 10, 10 ],
	[ 1, 1, 10, 1, 1, 1, 10, 22, 1, 1, 21, 10, 1, 1, 1, 24 ],
	[ 7, 7, 1, 1, 1, 10, 1, 10, 1, 10, 10, 1, 1, 10, 1, 10 ],
	[ 1, 10, 1, 1, 19, 20, 1, 1, 1, 10, 1, 10, 10, 1, 1, 10 ],
	[ 1, 1, 1, 1, 1, 10, 1, 10, 1, 1, 1, 1, 10, 24, 1, 1 ],
	[ 10, 1, 1, 1, 1, 18, 1, 1, 1, 1, 1, 10, 10, 1, 1, 1 ]
],
"objects": [
	{
		"x": 13568,
		"y": -8576,
		"type": "HAUNTED_TREE"
	},
	{
		"x": 13440,
		"y": -8704,
		"type": "HAUNTED_TREE"
	},
	{
		"x": 13600,
		"y": -8352,
		"type": "HAUNTED_TREE"
	},
	{
		"x": 13376,
		"y": -8480,
		"type": "HAUNTED_TREE"
	},
	{
		"x": 13408,
		"y": -8288,
		"type": "HAUNTED_TREE"
	},
	{
		"x": 13664,
		"y": -8704,
		"type": "HAUNTED_TREE"
	},
	{
		"x": 13760,
		"y": -8352,
		"type": "HAUNTED_TREE"
	},
	{
		"x": 13728,
		"y": -8480,
		"type": "HAUNTED_TREE"
	},
	{
		"x": 13312,
		"y": -8704,
		"type": "HAUNTED_TREE"
	},
	{
		"x": 13792,
		"y": -8608,
		"type": "HAUNTED_TREE"
	},
	{
		"x": 13760,
		"y": -8224,
		"type": "HAUNTED_TREE"
	},
	{
		"x": 13568,
		"y": -8224,
		"type": "DEAD_TREE"
	}
]
}