{
"x": 2,
"y": 2,
"biomeType": "SNOW",
"tileData": [
	[ 1, 10, 24, 10, 18, 1, 10, 1, 1, 10, 10, 1, 10, 1, 8, 8 ],
	[ 1, 10, 10, 1, 1, 1, 10, 10, 1, 24, 1, 1, 5, 5, 5, 5 ],
	[ 11, 20, 12, 1, 1, 1, 20, 10, 1, 24, 10, 5, 5, 5, 5, 7 ],
	[ 11, 20, 11, 11, 11, 1, 18, 22, 1, 1, 1, 7, 5, 5, 5, 5 ],
	[ 1, 11, 11, 11, 11, 12, 11, 10, 11, 1, 4, 5, 7, 5, 7, 7 ],
	[ 10, 11, 11, 1, 11, 11, 12, 11, 11, 10, 1, 5, 5, 9, 5, 5 ],
	[ 11, 12, 1, 12, 1, 12, 11, 11, 11, 11, 4, 6, 1, 5, 5, 7 ],
	[ 12, 20, 10, 11, 1, 11, 11, 1, 12, 1, 4, 4, 4, 4, 4, 5 ],
	[ 12, 1, 10, 10, 11, 11, 10, 1, 4, 4, 4, 4, 4, 4, 1, 1 ],
	[ 12, 11, 1, 11, 11, 12, 12, 4, 4, 4, 4, 4, 4, 4, 4, 4 ],
	[ 11, 12, 11, 11, 11, 4, 4, 4, 4, 4, 4, 4, 1, 1, 1, 4 ],
	[ 11, 11, 11, 4, 4, 4, 4, 4, 4, 4, 4, 4, 1, 4, 4, 4 ],
	[ 11, 11, 4, 4, 1, 4, 4, 4, 4, 4, 4, 4, 1, 4, 4, 4 ],
	[ 11, 1, 4, 4, 1, 1, 1, 4, 4, 4, 1, 4, 1, 4, 4, 4 ],
	[ 4, 4, 4, 4, 4, 4, 4, 4, 6, 4, 4, 4, 4, 4, 1, 4 ],
	[ 1, 4, 1, 4, 4, 4, 4, 4, 4, 4, 4, 4, 4, 4, 4, 4 ]
],
"objects": [
	{
		"x": 1152,
		"y": 1024,
		"type": "SNOW_TREE"
	},
	{
		"x": 1312,
		"y": 1376,
		"type": "SNOW_TREE"
	},
	{
		"x": 1344,
		"y": 1184,
		"type": "SNOW_TREE"
	},
	{
		"x": 1056,
		"y": 1184,
		"type": "SNOW_TREE"
	},
	{
		"x": 1472,
		"y": 1376,
		"type": "SNOW_TREE"
	},
	{
		"x": 1024,
		"y": 1024,
		"type": "SNOW_TREE"
	},
	{
		"x": 1120,
		"y": 1344,
		"type": "SNOW_TREE"
	},
	{
		"x": 1504,
		"y": 1120,
		"type": "SNOW_TREE"
	},
	{
		"x": 1472,
		"y": 1504,
		"type": "SNOW_TREE"
	},
	{
		"x": 1280,
		"y": 1056,
		"type": "SNOW_TREE"
	},
	{
		"x": 1248,
		"y": 1312,
		"type": "POKEBALL"
	}
]
}