{
"x": 24,
"y": -22,
"biomeType": "HAUNTED",
"tileData": [
	[ 7, 5, 7, 5, 7, 5, 5, 5, 9, 5, 7, 7, 5, 5, 1, 5 ],
	[ 5, 7, 5, 5, 5, 5, 5, 5, 7, 5, 8, 1, 7, 7, 5, 7 ],
	[ 5, 5, 5, 8, 5, 7, 5, 5, 5, 7, 5, 5, 5, 7, 5, 5 ],
	[ 5, 5, 5, 5, 5, 7, 5, 5, 7, 1, 5, 8, 9, 7, 5, 5 ],
	[ 8, 5, 5, 5, 5, 5, 5, 7, 5, 7, 5, 5, 7, 5, 8, 5 ],
	[ 8, 5, 5, 5, 5, 5, 8, 5, 7, 7, 1, 7, 5, 5, 5, 1 ],
	[ 5, 5, 9, 5, 5, 5, 7, 8, 5, 7, 7, 5, 5, 9, 7, 7 ],
	[ 5, 9, 5, 5, 8, 5, 5, 5, 9, 5, 5, 8, 5, 8, 5, 7 ],
	[ 9, 7, 7, 5, 7, 8, 5, 9, 5, 5, 5, 8, 7, 7, 7, 7 ],
	[ 7, 5, 8, 8, 7, 5, 5, 5, 7, 5, 5, 5, 7, 5, 7, 5 ],
	[ 5, 5, 9, 5, 5, 9, 5, 7, 5, 5, 7, 5, 8, 5, 5, 8 ],
	[ 5, 5, 7, 1, 5, 5, 5, 7, 5, 5, 5, 5, 7, 5, 7, 5 ],
	[ 9, 7, 5, 1, 7, 5, 5, 5, 9, 7, 5, 5, 5, 7, 5, 5 ],
	[ 7, 7, 7, 5, 5, 7, 1, 5, 5, 5, 5, 5, 7, 5, 5, 7 ],
	[ 15, 5, 5, 7, 5, 8, 5, 5, 8, 5, 5, 5, 9, 5, 9, 5 ],
	[ 17, 15, 15, 15, 15, 15, 9, 5, 7, 7, 8, 5, 7, 7, 5, 5 ]
],
"objects": [
	{
		"x": 12544,
		"y": -11136,
		"type": "HAUNTED_TREE"
	},
	{
		"x": 12416,
		"y": -11264,
		"type": "HAUNTED_TREE"
	},
	{
		"x": 12576,
		"y": -10912,
		"type": "HAUNTED_TREE"
	},
	{
		"x": 12352,
		"y": -11040,
		"type": "HAUNTED_TREE"
	},
	{
		"x": 12384,
		"y": -10848,
		"type": "HAUNTED_TREE"
	},
	{
		"x": 12640,
		"y": -11264,
		"type": "HAUNTED_TREE"
	},
	{
		"x": 12736,
		"y": -10912,
		"type": "HAUNTED_TREE"
	},
	{
		"x": 12672,
		"y": -11040,
		"type": "HAUNTED_TREE"
	},
	{
		"x": 12288,
		"y": -11264,
		"type": "HAUNTED_TREE"
	},
	{
		"x": 12736,
		"y": -10784,
		"type": "HAUNTED_TREE"
	},
	{
		"x": 12576,
		"y": -10784,
		"type": "HAUNTED_TREE"
	}
]
}