{
"x": -1,
"y": -4,
"biomeType": "FOREST",
"tileData": [
	[ 11, 12, 11, 11, 11, 10, 11, 12, 12, 11, 11, 12, 10, 10, 1, 11 ],
	[ 1, 11, 11, 11, 12, 11, 12, 12, 11, 11, 11, 11, 11, 11, 11, 1 ],
	[ 1, 11, 11, 12, 12, 1, 1, 11, 11, 11, 1, 11, 11, 10, 11, 11 ],
	[ 11, 10, 11, 1, 11, 12, 12, 11, 11, 11, 11, 11, 12, 11, 11, 11 ],
	[ 11, 12, 11, 11, 12, 12, 11, 10, 1, 11, 11, 11, 11, 11, 11, 12 ],
	[ 20, 12, 12, 11, 12, 11, 12, 11, 12, 11, 11, 11, 11, 11, 12, 12 ],
	[ 12, 11, 12, 11, 11, 12, 11, 1, 11, 12, 11, 11, 11, 12, 11, 11 ],
	[ 10, 1, 11, 11, 11, 11, 11, 11, 11, 12, 11, 11, 20, 11, 12, 12 ],
	[ 10, 1, 11, 11, 1, 1, 11, 11, 12, 11, 11, 11, 12, 10, 12, 11 ],
	[ 1, 1, 10, 11, 11, 11, 11, 12, 11, 11, 11, 10, 11, 11, 11, 11 ],
	[ 1, 1, 1, 10, 11, 12, 11, 11, 11, 12, 1, 11, 11, 12, 11, 11 ],
	[ 10, 1, 1, 1, 11, 1, 11, 11, 12, 1, 11, 12, 11, 11, 11, 11 ],
	[ 1, 1, 1, 1, 1, 11, 11, 11, 10, 10, 11, 11, 11, 11, 12, 1 ],
	[ 22, 10, 10, 1, 1, 11, 11, 11, 11, 11, 11, 11, 10, 1, 11, 11 ],
	[ 1, 1, 1, 1, 10, 1, 11, 11, 12, 11, 11, 11, 1, 1, 11, 10 ],
	[ 1, 1, 1, 1, 21, 1, 11, 1, 1, 11, 11, 11, 1, 12, 12, 12 ]
],
"objects": [
	{
		"x": -256,
		"y": -1920,
		"type": "TREE_0"
	},
	{
		"x": -384,
		"y": -2048,
		"type": "TREE_0"
	},
	{
		"x": -224,
		"y": -1696,
		"type": "TREE_0"
	},
	{
		"x": -448,
		"y": -1824,
		"type": "TREE_0"
	},
	{
		"x": -416,
		"y": -1632,
		"type": "TREE_0"
	},
	{
		"x": -160,
		"y": -2048,
		"type": "TREE_0"
	},
	{
		"x": -64,
		"y": -1696,
		"type": "TREE_0"
	},
	{
		"x": -128,
		"y": -1824,
		"type": "TREE_0"
	},
	{
		"x": -512,
		"y": -2048,
		"type": "TREE_0"
	},
	{
		"x": -32,
		"y": -1952,
		"type": "TREE_0"
	},
	{
		"x": -64,
		"y": -1568,
		"type": "TREE_0"
	},
	{
		"x": -224,
		"y": -1568,
		"type": "TREE_1"
	}
]
}