{
"x": 27,
"y": -20,
"biomeType": "PLAINS",
"tileData": [
	[ 1, 20, 10, 1, 1, 10, 1, 10, 19, 1, 1, 21, 1, 10, 10, 1 ],
	[ 22, 10, 1, 23, 19, 1, 1, 10, 24, 10, 18, 20, 1, 1, 1, 10 ],
	[ 10, 1, 1, 24, 1, 1, 19, 10, 21, 1, 10, 1, 1, 20, 21, 1 ],
	[ 1, 1, 1, 10, 10, 1, 1, 1, 1, 1, 1, 1, 22, 20, 1, 1 ],
	[ 21, 10, 10, 10, 1, 1, 19, 1, 1, 1, 1, 1, 23, 1, 1, 1 ],
	[ 20, 10, 1, 21, 1, 24, 1, 1, 1, 10, 1, 1, 1, 1, 18, 1 ],
	[ 1, 1, 1, 1, 1, 1, 10, 1, 1, 1, 1, 10, 1, 1, 10, 1 ],
	[ 1, 10, 18, 1, 1, 1, 1, 1, 10, 24, 19, 10, 1, 10, 1, 1 ],
	[ 1, 22, 1, 1, 1, 10, 10, 1, 10, 1, 1, 10, 1, 1, 1, 10 ],
	[ 1, 21, 20, 10, 1, 1, 1, 18, 1, 1, 1, 1, 1, 10, 1, 1 ],
	[ 1, 21, 18, 1, 10, 1, 24, 1, 1, 10, 1, 1, 10, 1, 1, 24 ],
	[ 18, 20, 1, 1, 22, 23, 1, 1, 10, 1, 1, 1, 1, 1, 1, 1 ],
	[ 20, 1, 10, 18, 21, 1, 1, 1, 1, 1, 1, 1, 23, 1, 20, 1 ],
	[ 1, 10, 1, 19, 1, 24, 1, 1, 1, 10, 1, 1, 19, 18, 1, 10 ],
	[ 10, 10, 23, 21, 10, 1, 10, 10, 1, 1, 1, 10, 1, 10, 1, 1 ],
	[ 23, 1, 18, 1, 1, 10, 10, 1, 10, 1, 20, 1, 1, 10, 1, 1 ]
],
"objects": [
	{
		"x": 14080,
		"y": -10112,
		"type": "TREE_0"
	},
	{
		"x": 13952,
		"y": -10240,
		"type": "TREE_0"
	},
	{
		"x": 14112,
		"y": -9888,
		"type": "TREE_0"
	},
	{
		"x": 13888,
		"y": -10016,
		"type": "TREE_0"
	},
	{
		"x": 13920,
		"y": -9824,
		"type": "TREE_0"
	},
	{
		"x": 14176,
		"y": -10240,
		"type": "TREE_0"
	},
	{
		"x": 14272,
		"y": -9888,
		"type": "TREE_0"
	},
	{
		"x": 14208,
		"y": -10016,
		"type": "TREE_0"
	},
	{
		"x": 13824,
		"y": -10240,
		"type": "TREE_0"
	},
	{
		"x": 14304,
		"y": -10144,
		"type": "TREE_0"
	},
	{
		"x": 14272,
		"y": -9760,
		"type": "TREE_0"
	},
	{
		"x": 14112,
		"y": -9760,
		"type": "TREE_1"
	}
]
}