{
"y": 3,
"biomeType": "HAUNTED",
"tileData": [
	[ 7, 5, 8, 8, 8, 5, 5, 5, 5, 8, 5, 5, 5, 5, 7, 5 ],
	[ 7, 5, 5, 5, 8, 5, 5, 5, 8, 8, 5, 8, 5, 7, 7, 7 ],
	[ 5, 8, 7, 7, 8, 7, 5, 7, 1, 7, 1, 7, 5, 5, 8, 7 ],
	[ 5, 7, 5, 7, 7, 7, 7, 5, 5, 7, 5, 5, 5, 7, 5, 5 ],
	[ 5, 8, 5, 5, 5, 5, 5, 7, 7, 7, 5, 5, 8, 7, 7, 7 ],
	[ 7, 5, 5, 5, 5, 1, 5, 9, 5, 7, 5, 7, 7, 7, 7, 5 ],
	[ 8, 7, 5, 5, 7, 5, 8, 5, 5, 5, 5, 5, 5, 5, 7, 7 ],
	[ 5, 7, 5, 7, 5, 7, 5, 5, 5, 5, 5, 5, 5, 7, 5, 7 ],
	[ 5, 7, 5, 7, 5, 5, 7, 5, 5, 5, 5, 8, 9, 5, 5, 5 ],
	[ 8, 5, 5, 7, 1, 7, 5, 1, 5, 5, 8, 5, 7, 5, 9, 9 ],
	[ 5, 5, 5, 1, 5, 5, 5, 5, 7, 8, 7, 5, 5, 5, 5, 5 ],
	[ 5, 5, 5, 5, 5, 5, 7, 7, 5, 5, 5, 5, 5, 5, 5, 5 ],
	[ 1, 1, 1, 1, 1, 19, 5, 5, 8, 7, 5, 5, 5, 7, 7, 5 ],
	[ 1, 1, 1, 1, 1, 1, 20, 10, 1, 1, 1, 1, 5, 8, 7, 7 ],
	[ 1, 1, 1, 10, 1, 1, 21, 1, 1, 1, 20, 22, 1, 1, 10, 5 ],
	[ 1, 19, 10, 10, 1, 10, 1, 1, 18, 1, 1, 1, 1, 1, 1, 1 ]
],
"objects": [
	{
		"x": 256,
		"y": 1664,
		"type": "HAUNTED_TREE"
	},
	{
		"x": 128,
		"y": 1536,
		"type": "HAUNTED_TREE"
	},
	{
		"x": 288,
		"y": 1888,
		"type": "HAUNTED_TREE"
	},
	{
		"x": 64,
		"y": 1760,
		"type": "HAUNTED_TREE"
	},
	{
		"x": 96,
		"y": 1952,
		"type": "HAUNTED_TREE"
	},
	{
		"x": 352,
		"y": 1536,
		"type": "HAUNTED_TREE"
	},
	{
		"x": 384,
		"y": 1760,
		"type": "HAUNTED_TREE"
	},
	{
		"x": 416,
		"y": 1984,
		"type": "HAUNTED_TREE"
	},
	{
		"y": 1536,
		"type": "HAUNTED_TREE"
	},
	{
		"x": 288,
		"y": 2016,
		"type": "HAUNTED_TREE"
	},
	{
		"x": 480,
		"y": 1536,
		"type": "HAUNTED_TREE"
	},
	{
		"x": 480,
		"y": 1888,
		"type": "POKEBALL"
	}
]
}