{
"x": 3,
"y": -3,
"biomeType": "FOREST",
"tileData": [
	[ 11, 10, 12, 11, 11, 11, 1, 11, 11, 12, 11, 11, 1, 11, 11, 1 ],
	[ 12, 11, 11, 11, 20, 10, 11, 10, 20, 11, 11, 1, 11, 11, 12, 12 ],
	[ 12, 11, 1, 1, 11, 11, 11, 11, 11, 11, 20, 11, 11, 11, 1, 11 ],
	[ 1, 1, 11, 10, 11, 12, 12, 11, 11, 11, 11, 11, 10, 11, 11, 10 ],
	[ 11, 11, 11, 11, 11, 10, 11, 11, 12, 1, 11, 11, 12, 11, 11, 12 ],
	[ 10, 10, 11, 11, 1, 11, 11, 10, 1, 11, 11, 11, 11, 12, 1, 12 ],
	[ 11, 11, 12, 1, 12, 11, 11, 11, 11, 11, 1, 1, 10, 12, 11, 11 ],
	[ 11, 11, 11, 12, 11, 12, 12, 11, 11, 1, 11, 11, 10, 11, 11, 11 ],
	[ 11, 12, 1, 1, 12, 12, 11, 11, 1, 1, 10, 11, 12, 11, 11, 11 ],
	[ 12, 12, 1, 11, 11, 11, 10, 12, 12, 12, 10, 11, 11, 12, 11, 12 ],
	[ 12, 11, 1, 11, 11, 1, 11, 11, 12, 20, 11, 11, 11, 1, 11, 11 ],
	[ 12, 12, 11, 11, 10, 1, 12, 11, 20, 11, 11, 12, 1, 11, 12, 11 ],
	[ 1, 11, 11, 11, 12, 11, 11, 20, 11, 11, 12, 11, 1, 11, 1, 11 ],
	[ 11, 11, 12, 11, 12, 12, 12, 10, 11, 12, 1, 11, 11, 1, 12, 11 ],
	[ 11, 1, 1, 1, 12, 12, 12, 11, 11, 20, 11, 12, 1, 11, 11, 12 ],
	[ 1, 20, 11, 1, 11, 11, 11, 11, 11, 1, 10, 12, 11, 11, 12, 11 ]
],
"objects": [
	{
		"x": 1792,
		"y": -1408,
		"type": "TREE_0"
	},
	{
		"x": 1664,
		"y": -1536,
		"type": "TREE_0"
	},
	{
		"x": 1824,
		"y": -1184,
		"type": "TREE_0"
	},
	{
		"x": 1600,
		"y": -1312,
		"type": "TREE_0"
	},
	{
		"x": 1632,
		"y": -1120,
		"type": "TREE_0"
	},
	{
		"x": 1888,
		"y": -1536,
		"type": "TREE_0"
	},
	{
		"x": 1984,
		"y": -1184,
		"type": "TREE_0"
	},
	{
		"x": 1920,
		"y": -1312,
		"type": "TREE_0"
	},
	{
		"x": 1536,
		"y": -1536,
		"type": "TREE_0"
	},
	{
		"x": 2016,
		"y": -1440,
		"type": "TREE_0"
	},
	{
		"x": 1984,
		"y": -1056,
		"type": "TREE_0"
	},
	{
		"x": 1824,
		"y": -1056,
		"type": "TREE_1"
	}
]
}