{
"x": -2,
"biomeType": "PLAINS",
"tileData": [
	[ 1, 1, 18, 1, 1, 1, 1, 1, 1, 1, 1, 1, 1, 1, 1, 21 ],
	[ 23, 18, 1, 1, 10, 1, 24, 10, 22, 1, 1, 19, 10, 1, 10, 1 ],
	[ 18, 10, 1, 1, 21, 23, 1, 1, 18, 1, 10, 1, 20, 1, 1, 1 ],
	[ 1, 10, 1, 19, 10, 10, 10, 19, 1, 1, 1, 1, 1, 1, 1, 1 ],
	[ 1, 10, 1, 1, 1, 10, 1, 1, 1, 1, 1, 1, 1, 10, 1, 10 ],
	[ 1, 1, 10, 1, 10, 20, 1, 10, 1, 1, 1, 10, 1, 1, 10, 1 ],
	[ 1, 18, 24, 1, 1, 10, 1, 1, 20, 22, 1, 10, 1, 1, 10, 18 ],
	[ 10, 1, 19, 1, 1, 10, 10, 1, 1, 1, 1, 1, 1, 1, 10, 1 ],
	[ 1, 1, 18, 1, 1, 10, 1, 10, 1, 18, 1, 1, 1, 10, 5, 21 ],
	[ 1, 1, 1, 1, 1, 1, 1, 1, 19, 1, 10, 1, 1, 1, 9, 5 ],
	[ 1, 1, 1, 19, 1, 19, 1, 20, 1, 1, 9, 1, 1, 1, 1, 1 ],
	[ 1, 10, 1, 1, 18, 24, 20, 1, 10, 1, 5, 9, 1, 1, 5, 5 ],
	[ 1, 1, 1, 1, 1, 1, 1, 19, 18, 10, 9, 22, 5, 5, 7, 9 ],
	[ 1, 10, 18, 1, 1, 1, 10, 1, 10, 20, 24, 10, 5, 5, 5, 5 ],
	[ 19, 1, 1, 10, 1, 1, 20, 1, 19, 1, 5, 1, 5, 5, 8, 5 ],
	[ 19, 1, 1, 1, 10, 1, 1, 20, 1, 1, 1, 1, 9, 5, 1, 5 ]
],
"objects": [
	{
		"x": -768,
		"y": 128,
		"type": "TREE_0"
	},
	{
		"x": -896,
		"type": "TREE_0"
	},
	{
		"x": -736,
		"y": 352,
		"type": "TREE_0"
	},
	{
		"x": -960,
		"y": 224,
		"type": "TREE_0"
	},
	{
		"x": -928,
		"y": 416,
		"type": "TREE_0"
	},
	{
		"x": -672,
		"type": "TREE_0"
	},
	{
		"x": -576,
		"y": 352,
		"type": "TREE_0"
	},
	{
		"x": -640,
		"y": 224,
		"type": "TREE_0"
	},
	{
		"x": -1024,
		"type": "TREE_0"
	},
	{
		"x": -544,
		"y": 96,
		"type": "TREE_0"
	},
	{
		"x": -640,
		"y": 128,
		"type": "POKEBALL"
	}
]
}