{
"x": -1,
"y": 2,
"biomeType": "HAUNTED",
"tileData": [
	[ 1, 1, 1, 1, 10, 1, 1, 10, 1, 1, 10, 5, 5, 5, 1, 1 ],
	[ 24, 1, 10, 1, 1, 21, 1, 22, 5, 7, 5, 7, 7, 7, 7, 5 ],
	[ 1, 21, 1, 1, 10, 20, 1, 9, 5, 7, 5, 8, 5, 7, 9, 5 ],
	[ 1, 10, 1, 1, 10, 1, 5, 5, 5, 5, 5, 9, 7, 7, 5, 5 ],
	[ 1, 1, 1, 1, 1, 1, 5, 7, 5, 5, 5, 5, 8, 9, 5, 5 ],
	[ 1, 19, 10, 1, 1, 8, 5, 5, 5, 8, 5, 5, 5, 7, 5, 5 ],
	[ 1, 1, 10, 1, 1, 7, 5, 5, 5, 5, 1, 5, 5, 5, 5, 5 ],
	[ 10, 24, 1, 22, 10, 5, 5, 9, 5, 7, 5, 5, 7, 7, 7, 7 ],
	[ 1, 1, 10, 10, 1, 5, 5, 5, 5, 8, 5, 5, 8, 7, 7, 7 ],
	[ 1, 1, 10, 10, 1, 5, 7, 1, 5, 7, 5, 5, 5, 7, 8, 7 ],
	[ 24, 10, 1, 1, 21, 9, 9, 5, 7, 5, 5, 9, 5, 7, 9, 5 ],
	[ 1, 1, 10, 1, 20, 8, 1, 7, 5, 5, 7, 7, 5, 5, 5, 5 ],
	[ 1, 1, 10, 1, 1, 9, 7, 5, 8, 7, 8, 5, 1, 7, 5, 5 ],
	[ 1, 10, 1, 1, 7, 5, 5, 7, 5, 5, 7, 5, 5, 5, 5, 5 ],
	[ 1, 10, 18, 21, 1, 5, 5, 7, 5, 5, 7, 5, 5, 5, 5, 5 ],
	[ 10, 1, 23, 1, 1, 5, 5, 5, 5, 5, 5, 5, 5, 5, 5, 5 ]
],
"objects": [
	{
		"x": -256,
		"y": 1152,
		"type": "HAUNTED_TREE"
	},
	{
		"x": -384,
		"y": 1024,
		"type": "HAUNTED_TREE"
	},
	{
		"x": -224,
		"y": 1376,
		"type": "HAUNTED_TREE"
	},
	{
		"x": -448,
		"y": 1248,
		"type": "HAUNTED_TREE"
	},
	{
		"x": -416,
		"y": 1440,
		"type": "HAUNTED_TREE"
	},
	{
		"x": -160,
		"y": 1024,
		"type": "HAUNTED_TREE"
	},
	{
		"x": -64,
		"y": 1376,
		"type": "HAUNTED_TREE"
	},
	{
		"x": -128,
		"y": 1248,
		"type": "HAUNTED_TREE"
	},
	{
		"x": -512,
		"y": 1024,
		"type": "HAUNTED_TREE"
	},
	{
		"x": -32,
		"y": 1120,
		"type": "HAUNTED_TREE"
	},
	{
		"x": -64,
		"y": 1504,
		"type": "HAUNTED_TREE"
	},
	{
		"x": -224,
		"y": 1504,
		"type": "HAUNTED_TREE"
	},
	{
		"x": -192,
		"y": 1088,
		"type": "POKEBALL"
	}
]
}