{
"x": -1,
"y": -2,
"biomeType": "FOREST",
"tileData": [
	[ 11, 11, 10, 11, 12, 12, 11, 12, 11, 10, 11, 12, 12, 11, 12, 1 ],
	[ 11, 1, 11, 12, 11, 11, 11, 12, 10, 1, 11, 11, 11, 12, 11, 12 ],
	[ 20, 1, 11, 10, 11, 11, 12, 11, 11, 1, 12, 11, 11, 12, 12, 11 ],
	[ 11, 12, 12, 11, 11, 12, 11, 10, 12, 10, 11, 12, 11, 11, 11, 20 ],
	[ 11, 11, 11, 11, 12, 12, 11, 12, 11, 11, 10, 11, 11, 11, 12, 11 ],
	[ 11, 11, 11, 11, 1, 12, 1, 11, 11, 11, 11, 11, 12, 11, 11, 11 ],
	[ 11, 12, 11, 11, 11, 11, 11, 11, 11, 11, 11, 11, 11, 11, 11, 11 ],
	[ 11, 11, 12, 11, 11, 11, 11, 11, 11, 1, 11, 1, 12, 11, 11, 11 ],
	[ 11, 1, 1, 12, 11, 11, 11, 12, 11, 11, 1, 1, 11, 11, 12, 12 ],
	[ 11, 12, 12, 11, 11, 11, 1, 11, 12, 20, 11, 11, 10, 11, 12, 11 ],
	[ 11, 11, 12, 11, 11, 11, 11, 11, 10, 11, 11, 11, 12, 11, 12, 1 ],
	[ 11, 10, 11, 11, 11, 1, 12, 12, 12, 11, 11, 12, 11, 11, 12, 1 ],
	[ 12, 11, 12, 11, 12, 11, 10, 11, 11, 11, 12, 11, 11, 1, 12, 11 ],
	[ 11, 11, 12, 12, 11, 20, 11, 11, 12, 11, 11, 11, 1, 12, 11, 1 ],
	[ 11, 20, 1, 11, 11, 11, 11, 12, 11, 10, 10, 20, 11, 11, 11, 20 ],
	[ 1, 12, 12, 11, 11, 11, 11, 12, 11, 11, 12, 12, 11, 11, 12, 11 ]
],
"objects": [
	{
		"x": -256,
		"y": -896,
		"type": "TREE_0"
	},
	{
		"x": -384,
		"y": -1024,
		"type": "TREE_0"
	},
	{
		"x": -224,
		"y": -672,
		"type": "TREE_0"
	},
	{
		"x": -448,
		"y": -800,
		"type": "TREE_0"
	},
	{
		"x": -416,
		"y": -608,
		"type": "TREE_0"
	},
	{
		"x": -160,
		"y": -1024,
		"type": "TREE_0"
	},
	{
		"x": -64,
		"y": -672,
		"type": "TREE_0"
	},
	{
		"x": -128,
		"y": -800,
		"type": "TREE_0"
	},
	{
		"x": -512,
		"y": -1024,
		"type": "TREE_0"
	},
	{
		"x": -32,
		"y": -928,
		"type": "TREE_0"
	},
	{
		"x": -64,
		"y": -544,
		"type": "TREE_0"
	},
	{
		"x": -224,
		"y": -544,
		"type": "TREE_1"
	},
	{
		"x": -352,
		"y": -896,
		"type": "POKEBALL"
	}
]
}