{
"y": -1,
"biomeType": "FOREST",
"tileData": [
	[ 11, 11, 11, 11, 20, 11, 11, 11, 11, 11, 11, 12, 11, 11, 10, 1 ],
	[ 10, 11, 10, 11, 11, 11, 11, 1, 11, 11, 11, 11, 10, 12, 12, 1 ],
	[ 11, 11, 1, 11, 11, 12, 12, 11, 12, 11, 1, 11, 12, 12, 11, 1 ],
	[ 11, 11, 10, 11, 12, 11, 11, 11, 20, 20, 12, 11, 11, 11, 11, 12 ],
	[ 10, 12, 11, 1, 11, 11, 1, 11, 11, 11, 12, 11, 11, 11, 1, 11 ],
	[ 11, 11, 11, 11, 11, 1, 1, 11, 11, 11, 11, 11, 12, 12, 11, 12 ],
	[ 12, 11, 11, 11, 11, 1, 11, 12, 11, 11, 11, 12, 12, 11, 11, 12 ],
	[ 1, 11, 11, 11, 11, 10, 20, 20, 1, 11, 12, 11, 11, 11, 12, 11 ],
	[ 11, 11, 11, 12, 11, 1, 11, 11, 11, 10, 1, 12, 11, 20, 11, 11 ],
	[ 11, 12, 1, 12, 1, 11, 10, 11, 10, 11, 11, 11, 12, 11, 11, 12 ],
	[ 12, 11, 11, 11, 12, 11, 11, 1, 12, 20, 1, 11, 11, 11, 11, 11 ],
	[ 12, 11, 12, 1, 12, 11, 11, 11, 20, 12, 1, 12, 11, 12, 12, 12 ],
	[ 11, 11, 11, 11, 11, 10, 11, 11, 11, 1, 12, 11, 11, 12, 11, 1 ],
	[ 12, 11, 11, 11, 12, 12, 11, 1, 11, 1, 11, 11, 12, 11, 11, 11 ],
	[ 11, 11, 11, 1, 12, 11, 12, 1, 11, 11, 11, 11, 1, 12, 12, 12 ],
	[ 12, 11, 11, 11, 12, 1, 12, 10, 11, 12, 11, 12, 11, 1, 11, 11 ]
],
"objects": [
	{
		"x": 256,
		"y": -384,
		"type": "TREE_0"
	},
	{
		"x": 128,
		"y": -512,
		"type": "TREE_0"
	},
	{
		"x": 288,
		"y": -160,
		"type": "TREE_0"
	},
	{
		"x": 64,
		"y": -288,
		"type": "TREE_0"
	},
	{
		"x": 96,
		"y": -96,
		"type": "TREE_0"
	},
	{
		"x": 352,
		"y": -512,
		"type": "TREE_0"
	},
	{
		"x": 448,
		"y": -160,
		"type": "TREE_0"
	},
	{
		"x": 384,
		"y": -288,
		"type": "TREE_0"
	},
	{
		"y": -512,
		"type": "TREE_0"
	},
	{
		"x": 480,
		"y": -416,
		"type": "TREE_0"
	},
	{
		"x": 448,
		"y": -32,
		"type": "TREE_0"
	},
	{
		"x": 288,
		"y": -32,
		"type": "TREE_1"
	},
	{
		"x": 288,
		"y": -448,
		"type": "POKEBALL"
	}
]
}