{
"x": 2,
"y": -4,
"biomeType": "FOREST",
"tileData": [
	[ 12, 11, 12, 11, 11, 10, 11, 11, 12, 12, 10, 11, 11, 11, 11, 11 ],
	[ 11, 12, 11, 11, 11, 12, 10, 11, 12, 11, 11, 11, 12, 11, 11, 12 ],
	[ 1, 1, 11, 10, 11, 11, 11, 11, 11, 11, 11, 1, 1, 11, 12, 11 ],
	[ 11, 11, 11, 11, 11, 11, 11, 11, 11, 12, 12, 11, 11, 1, 12, 11 ],
	[ 11, 11, 11, 10, 11, 20, 12, 11, 12, 10, 10, 11, 11, 11, 11, 10 ],
	[ 11, 10, 11, 12, 1, 11, 11, 11, 11, 11, 11, 12, 11, 11, 12, 12 ],
	[ 1, 1, 11, 11, 11, 11, 11, 11, 11, 12, 1, 11, 11, 12, 11, 11 ],
	[ 11, 10, 12, 12, 11, 12, 1, 1, 11, 12, 12, 11, 11, 12, 11, 10 ],
	[ 12, 10, 12, 11, 11, 11, 11, 11, 12, 12, 11, 10, 1, 11, 10, 11 ],
	[ 12, 11, 11, 11, 11, 11, 11, 11, 11, 11, 11, 1, 11, 12, 1, 11 ],
	[ 12, 11, 1, 1, 11, 12, 1, 11, 11, 10, 20, 11, 11, 12, 11, 11 ],
	[ 11, 10, 11, 11, 11, 11, 12, 11, 11, 11, 1, 11, 10, 11, 11, 10 ],
	[ 11, 1, 11, 11, 1, 11, 11, 11, 12, 11, 11, 12, 11, 11, 12, 11 ],
	[ 1, 11, 11, 12, 11, 11, 11, 11, 11, 11, 12, 1, 11, 11, 10, 11 ],
	[ 11, 12, 12, 10, 11, 11, 11, 10, 1, 11, 11, 11, 11, 11, 11, 11 ],
	[ 11, 12, 11, 11, 11, 1, 11, 11, 1, 12, 11, 12, 20, 1, 1, 12 ]
],
"objects": [
	{
		"x": 1280,
		"y": -1920,
		"type": "TREE_0"
	},
	{
		"x": 1152,
		"y": -2048,
		"type": "TREE_0"
	},
	{
		"x": 1312,
		"y": -1696,
		"type": "TREE_0"
	},
	{
		"x": 1088,
		"y": -1824,
		"type": "TREE_0"
	},
	{
		"x": 1120,
		"y": -1632,
		"type": "TREE_0"
	},
	{
		"x": 1376,
		"y": -2048,
		"type": "TREE_0"
	},
	{
		"x": 1472,
		"y": -1696,
		"type": "TREE_0"
	},
	{
		"x": 1408,
		"y": -1824,
		"type": "TREE_0"
	},
	{
		"x": 1024,
		"y": -2048,
		"type": "TREE_0"
	},
	{
		"x": 1504,
		"y": -1952,
		"type": "TREE_0"
	},
	{
		"x": 1472,
		"y": -1568,
		"type": "TREE_0"
	},
	{
		"x": 1312,
		"y": -1568,
		"type": "TREE_1"
	}
]
}