{
"x": 29,
"y": -22,
"biomeType": "PLAINS",
"tileData": [
	[ 1, 21, 1, 10, 10, 1, 10, 1, 1, 18, 10, 10, 1, 1, 1, 1 ],
	[ 1, 19, 1, 1, 1, 1, 1, 1, 1, 1, 1, 1, 1, 1, 19, 10 ],
	[ 1, 19, 1, 1, 1, 1, 19, 1, 1, 1, 20, 1, 1, 1, 10, 1 ],
	[ 20, 1, 1, 10, 10, 1, 20, 20, 10, 23, 1, 10, 1, 24, 1, 22 ],
	[ 10, 1, 1, 1, 10, 10, 1, 18, 10, 1, 1, 1, 20, 1, 1, 1 ],
	[ 1, 10, 1, 10, 10, 1, 1, 1, 1, 1, 19, 1, 1, 1, 1, 1 ],
	[ 1, 1, 1, 1, 10, 10, 1, 1, 1, 1, 1, 1, 24, 1, 1, 1 ],
	[ 1, 1, 1, 20, 1, 20, 10, 1, 21, 1, 1, 10, 1, 1, 1, 1 ],
	[ 1, 24, 1, 1, 1, 1, 10, 1, 10, 20, 1, 1, 1, 1, 10, 10 ],
	[ 1, 1, 24, 1, 1, 10, 22, 1, 21, 10, 19, 1, 1, 1, 1, 1 ],
	[ 1, 1, 1, 1, 1, 1, 24, 1, 1, 1, 1, 1, 18, 1, 1, 22 ],
	[ 10, 1, 1, 1, 10, 1, 1, 1, 1, 1, 10, 1, 1, 10, 10, 1 ],
	[ 21, 1, 1, 1, 1, 20, 23, 1, 1, 10, 1, 1, 1, 1, 1, 1 ],
	[ 1, 1, 21, 18, 10, 1, 22, 1, 10, 10, 18, 1, 1, 1, 1, 10 ],
	[ 1, 1, 23, 1, 10, 20, 1, 1, 1, 1, 1, 1, 10, 1, 10, 24 ],
	[ 1, 10, 18, 1, 1, 10, 1, 10, 10, 1, 1, 1, 1, 1, 19, 1 ]
],
"objects": [
	{
		"x": 15104,
		"y": -11136,
		"type": "TREE_0"
	},
	{
		"x": 14976,
		"y": -11264,
		"type": "TREE_0"
	},
	{
		"x": 15136,
		"y": -10912,
		"type": "TREE_0"
	},
	{
		"x": 14912,
		"y": -11040,
		"type": "TREE_0"
	},
	{
		"x": 14944,
		"y": -10848,
		"type": "TREE_0"
	},
	{
		"x": 15200,
		"y": -11264,
		"type": "TREE_0"
	},
	{
		"x": 15296,
		"y": -10912,
		"type": "TREE_0"
	},
	{
		"x": 15232,
		"y": -11040,
		"type": "TREE_0"
	},
	{
		"x": 14848,
		"y": -11264,
		"type": "TREE_0"
	},
	{
		"x": 15328,
		"y": -11168,
		"type": "TREE_0"
	},
	{
		"x": 15296,
		"y": -10784,
		"type": "TREE_0"
	},
	{
		"x": 15136,
		"y": -10784,
		"type": "TREE_1"
	}
]
}