{
"x": 26,
"y": -19,
"biomeType": "HAUNTED",
"tileData": [
	[ 5, 7, 5, 5, 7, 5, 5, 5, 5, 7, 5, 1, 5, 5, 5, 7 ],
	[ 9, 9, 5, 5, 7, 7, 5, 5, 7, 5, 9, 5, 5, 5, 8, 5 ],
	[ 7, 5, 7, 7, 5, 5, 7, 5, 7, 8, 7, 7, 5, 5, 7, 7 ],
	[ 7, 5, 7, 7, 7, 8, 8, 5, 5, 5, 7, 5, 1, 7, 5, 8 ],
	[ 7, 5, 5, 5, 5, 1, 7, 5, 9, 5, 7, 9, 5, 8, 7, 5 ],
	[ 5, 5, 5, 5, 7, 9, 5, 7, 5, 5, 7, 8, 5, 9, 7, 5 ],
	[ 10, 5, 7, 5, 5, 9, 7, 5, 7, 7, 5, 5, 8, 7, 5, 5 ],
	[ 1, 18, 1, 1, 8, 5, 5, 5, 7, 7, 7, 5, 5, 5, 7, 8 ],
	[ 15, 1, 1, 1, 1, 10, 10, 1, 5, 5, 5, 5, 5, 7, 5, 7 ],
	[ 15, 15, 1, 18, 1, 1, 1, 1, 1, 24, 7, 5, 1, 10, 7, 10 ],
	[ 15, 17, 15, 1, 1, 20, 1, 19, 1, 22, 1, 1, 1, 7, 5, 7 ],
	[ 10, 1, 1, 1, 20, 18, 1, 24, 20, 1, 1, 1, 21, 10, 1, 1 ],
	[ 10, 1, 1, 1, 1, 1, 1, 10, 1, 10, 1, 1, 10, 1, 10, 1 ],
	[ 1, 1, 19, 10, 1, 24, 1, 1, 1, 1, 10, 1, 10, 1, 1, 1 ],
	[ 1, 1, 10, 21, 1, 10, 10, 10, 1, 1, 1, 10, 20, 1, 1, 1 ],
	[ 10, 1, 21, 22, 1, 1, 1, 1, 1, 19, 10, 10, 1, 1, 20, 18 ]
],
"objects": [
	{
		"x": 13568,
		"y": -9600,
		"type": "HAUNTED_TREE"
	},
	{
		"x": 13440,
		"y": -9728,
		"type": "HAUNTED_TREE"
	},
	{
		"x": 13600,
		"y": -9376,
		"type": "HAUNTED_TREE"
	},
	{
		"x": 13376,
		"y": -9504,
		"type": "HAUNTED_TREE"
	},
	{
		"x": 13408,
		"y": -9312,
		"type": "HAUNTED_TREE"
	},
	{
		"x": 13728,
		"y": -9280,
		"type": "HAUNTED_TREE"
	},
	{
		"x": 13728,
		"y": -9504,
		"type": "HAUNTED_TREE"
	},
	{
		"x": 13312,
		"y": -9728,
		"type": "HAUNTED_TREE"
	},
	{
		"x": 13696,
		"y": -9664,
		"type": "HAUNTED_TREE"
	},
	{
		"x": 13568,
		"y": -9248,
		"type": "DEAD_TREE"
	}
]
}