{
"x": 26,
"y": -18,
"biomeType": "HAUNTED",
"tileData": [
	[ 5, 5, 5, 7, 5, 5, 8, 5, 5, 5, 5, 5, 5, 7, 5, 5 ],
	[ 5, 5, 5, 5, 7, 9, 5, 5, 9, 8, 7, 5, 5, 1, 7, 5 ],
	[ 5, 8, 5, 5, 7, 7, 5, 5, 5, 5, 7, 7, 7, 5, 8, 7 ],
	[ 1, 5, 5, 7, 5, 7, 7, 5, 5, 7, 7, 1, 7, 5, 7, 7 ],
	[ 5, 7, 7, 5, 5, 7, 5, 7, 5, 9, 9, 5, 5, 9, 5, 7 ],
	[ 7, 5, 5, 8, 5, 5, 7, 5, 5, 5, 5, 9, 5, 5, 5, 7 ],
	[ 7, 5, 5, 5, 8, 5, 5, 7, 8, 5, 7, 7, 5, 5, 7, 7 ],
	[ 5, 5, 5, 7, 5, 7, 5, 5, 5, 1, 5, 5, 5, 8, 5, 5 ],
	[ 7, 7, 5, 5, 7, 9, 9, 5, 5, 7, 5, 7, 5, 5, 9, 8 ],
	[ 1, 1, 1, 5, 5, 7, 7, 5, 5, 5, 7, 7, 5, 7, 5, 5 ],
	[ 7, 1, 1, 10, 5, 7, 5, 5, 5, 5, 5, 5, 5, 7, 5, 5 ],
	[ 1, 1, 21, 1, 10, 1, 1, 1, 7, 5, 5, 5, 1, 1, 7, 5 ],
	[ 10, 1, 1, 1, 1, 1, 1, 1, 7, 1, 1, 10, 5, 1, 7, 23 ],
	[ 1, 1, 1, 1, 19, 1, 1, 22, 18, 1, 10, 20, 1, 5, 10, 10 ],
	[ 18, 1, 1, 22, 1, 19, 1, 1, 18, 10, 1, 1, 1, 10, 20, 21 ],
	[ 20, 1, 10, 1, 18, 23, 1, 1, 23, 1, 1, 10, 10, 1, 10, 1 ]
],
"objects": [
	{
		"x": 13568,
		"y": -9088,
		"type": "HAUNTED_TREE"
	},
	{
		"x": 13440,
		"y": -9216,
		"type": "HAUNTED_TREE"
	},
	{
		"x": 13600,
		"y": -8864,
		"type": "HAUNTED_TREE"
	},
	{
		"x": 13376,
		"y": -8992,
		"type": "HAUNTED_TREE"
	},
	{
		"x": 13408,
		"y": -8800,
		"type": "HAUNTED_TREE"
	},
	{
		"x": 13664,
		"y": -9216,
		"type": "HAUNTED_TREE"
	},
	{
		"x": 13760,
		"y": -8864,
		"type": "HAUNTED_TREE"
	},
	{
		"x": 13696,
		"y": -8992,
		"type": "HAUNTED_TREE"
	},
	{
		"x": 13312,
		"y": -9216,
		"type": "HAUNTED_TREE"
	},
	{
		"x": 13792,
		"y": -9120,
		"type": "HAUNTED_TREE"
	},
	{
		"x": 13792,
		"y": -8736,
		"type": "HAUNTED_TREE"
	},
	{
		"x": 13600,
		"y": -8736,
		"type": "HAUNTED_TREE"
	}
]
}