{
"x": 1,
"y": -3,
"biomeType": "FOREST",
"tileData": [
	[ 12, 11, 12, 12, 11, 12, 11, 12, 12, 11, 11, 11, 11, 11, 12, 12 ],
	[ 12, 11, 12, 11, 11, 11, 11, 12, 12, 11, 11, 10, 11, 11, 11, 11 ],
	[ 10, 11, 11, 11, 12, 11, 11, 12, 10, 11, 11, 11, 12, 10, 11, 11 ],
	[ 12, 11, 11, 1, 11, 11, 1, 11, 11, 11, 11, 12, 10, 12, 11, 11 ],
	[ 11, 11, 10, 11, 11, 12, 11, 11, 11, 11, 11, 11, 11, 11, 11, 10 ],
	[ 11, 11, 11, 10, 11, 10, 11, 12, 11, 11, 11, 11, 11, 11, 11, 11 ],
	[ 12, 12, 10, 12, 11, 11, 11, 11, 11, 11, 12, 12, 11, 12, 11, 11 ],
	[ 11, 12, 1, 11, 11, 11, 1, 11, 11, 11, 12, 11, 11, 11, 12, 12 ],
	[ 11, 12, 10, 11, 11, 12, 11, 11, 12, 11, 11, 12, 11, 11, 11, 12 ],
	[ 1, 12, 11, 11, 11, 1, 12, 1, 11, 11, 11, 1, 11, 1, 20, 12 ],
	[ 10, 11, 11, 11, 11, 11, 11, 11, 11, 12, 11, 10, 12, 20, 12, 11 ],
	[ 11, 11, 12, 11, 11, 10, 11, 11, 11, 12, 12, 11, 20, 11, 11, 11 ],
	[ 11, 11, 11, 11, 12, 11, 11, 10, 1, 11, 11, 11, 11, 11, 12, 20 ],
	[ 11, 11, 10, 11, 1, 11, 12, 12, 11, 11, 11, 12, 11, 11, 11, 11 ],
	[ 11, 11, 12, 11, 11, 11, 11, 11, 12, 11, 11, 11, 11, 10, 11, 11 ],
	[ 10, 12, 11, 11, 10, 1, 12, 11, 1, 11, 11, 11, 11, 11, 1, 11 ]
],
"objects": [
	{
		"x": 768,
		"y": -1408,
		"type": "TREE_0"
	},
	{
		"x": 640,
		"y": -1536,
		"type": "TREE_0"
	},
	{
		"x": 800,
		"y": -1184,
		"type": "TREE_0"
	},
	{
		"x": 576,
		"y": -1312,
		"type": "TREE_0"
	},
	{
		"x": 608,
		"y": -1120,
		"type": "TREE_0"
	},
	{
		"x": 864,
		"y": -1536,
		"type": "TREE_0"
	},
	{
		"x": 960,
		"y": -1184,
		"type": "TREE_0"
	},
	{
		"x": 896,
		"y": -1312,
		"type": "TREE_0"
	},
	{
		"x": 512,
		"y": -1536,
		"type": "TREE_0"
	},
	{
		"x": 992,
		"y": -1440,
		"type": "TREE_0"
	},
	{
		"x": 960,
		"y": -1056,
		"type": "TREE_0"
	},
	{
		"x": 800,
		"y": -1056,
		"type": "TREE_1"
	}
]
}