{
"x": 24,
"y": -18,
"biomeType": "HAUNTED",
"tileData": [
	[ 5, 5, 5, 5, 5, 7, 5, 7, 5, 5, 5, 1, 7, 7, 7, 5 ],
	[ 5, 7, 7, 5, 7, 9, 9, 5, 7, 5, 7, 7, 5, 5, 5, 5 ],
	[ 5, 5, 5, 5, 8, 9, 5, 5, 7, 8, 7, 5, 5, 7, 5, 7 ],
	[ 8, 5, 7, 7, 7, 5, 5, 5, 5, 9, 8, 5, 5, 5, 9, 9 ],
	[ 5, 5, 5, 8, 5, 5, 7, 7, 5, 8, 5, 5, 7, 5, 7, 5 ],
	[ 5, 7, 5, 5, 5, 5, 5, 5, 5, 5, 5, 5, 5, 7, 9, 5 ],
	[ 5, 5, 7, 5, 7, 5, 7, 5, 7, 5, 5, 5, 7, 5, 7, 5 ],
	[ 5, 7, 5, 5, 9, 5, 5, 7, 5, 5, 8, 5, 5, 5, 5, 5 ],
	[ 5, 5, 5, 8, 5, 8, 8, 5, 5, 5, 5, 5, 1, 1, 5, 7 ],
	[ 5, 5, 1, 5, 1, 7, 5, 5, 5, 5, 5, 9, 5, 5, 7, 7 ],
	[ 5, 7, 9, 8, 7, 5, 7, 1, 5, 5, 7, 5, 7, 5, 7, 5 ],
	[ 9, 5, 7, 5, 5, 5, 5, 5, 5, 9, 5, 5, 5, 8, 5, 7 ],
	[ 5, 5, 5, 7, 5, 9, 7, 5, 7, 8, 5, 7, 5, 5, 5, 5 ],
	[ 5, 5, 5, 5, 5, 5, 7, 5, 1, 5, 5, 5, 1, 1, 5, 5 ],
	[ 5, 5, 5, 5, 5, 5, 7, 5, 5, 7, 5, 5, 7, 5, 7, 5 ],
	[ 5, 5, 5, 5, 5, 5, 5, 5, 5, 8, 5, 5, 9, 5, 7, 5 ]
],
"objects": [
	{
		"x": 12544,
		"y": -9088,
		"type": "HAUNTED_TREE"
	},
	{
		"x": 12416,
		"y": -9216,
		"type": "HAUNTED_TREE"
	},
	{
		"x": 12576,
		"y": -8864,
		"type": "HAUNTED_TREE"
	},
	{
		"x": 12352,
		"y": -8992,
		"type": "HAUNTED_TREE"
	},
	{
		"x": 12384,
		"y": -8800,
		"type": "HAUNTED_TREE"
	},
	{
		"x": 12640,
		"y": -9216,
		"type": "HAUNTED_TREE"
	},
	{
		"x": 12736,
		"y": -8864,
		"type": "HAUNTED_TREE"
	},
	{
		"x": 12672,
		"y": -8992,
		"type": "HAUNTED_TREE"
	},
	{
		"x": 12288,
		"y": -9216,
		"type": "HAUNTED_TREE"
	},
	{
		"x": 12768,
		"y": -9120,
		"type": "HAUNTED_TREE"
	},
	{
		"x": 12736,
		"y": -8736,
		"type": "HAUNTED_TREE"
	},
	{
		"x": 12576,
		"y": -8736,
		"type": "HAUNTED_TREE"
	}
]
}