{
"x": -1,
"y": 1,
"biomeType": "FOREST",
"tileData": [
	[ 5, 5, 5, 5, 5, 7, 5, 5, 5, 1, 1, 1, 1, 1, 1, 1 ],
	[ 5, 5, 7, 5, 8, 5, 5, 7, 5, 5, 5, 1, 10, 10, 1, 1 ],
	[ 5, 5, 7, 8, 5, 5, 5, 8, 7, 7, 1, 1, 1, 1, 1, 1 ],
	[ 5, 5, 8, 5, 5, 7, 5, 5, 9, 7, 8, 10, 1, 1, 1, 1 ],
	[ 5, 5, 5, 5, 5, 7, 5, 5, 5, 5, 5, 1, 24, 1, 1, 23 ],
	[ 5, 7, 5, 7, 1, 9, 5, 5, 7, 5, 5, 18, 10, 18, 1, 1 ],
	[ 5, 5, 5, 7, 7, 7, 5, 5, 5, 5, 5, 7, 21, 1, 10, 1 ],
	[ 5, 5, 5, 1, 5, 5, 5, 5, 7, 9, 7, 7, 21, 1, 1, 10 ],
	[ 7, 5, 7, 7, 8, 7, 7, 7, 5, 10, 7, 20, 10, 1, 1, 20 ],
	[ 20, 5, 5, 5, 5, 5, 7, 5, 5, 5, 1, 10, 1, 19, 10, 24 ],
	[ 1, 8, 5, 5, 5, 5, 8, 5, 5, 1, 7, 1, 1, 1, 10, 1 ],
	[ 1, 24, 5, 5, 5, 7, 5, 5, 8, 5, 5, 1, 21, 10, 19, 1 ],
	[ 18, 10, 1, 7, 7, 5, 5, 10, 5, 5, 5, 1, 1, 1, 10, 1 ],
	[ 10, 1, 1, 21, 20, 1, 1, 7, 5, 7, 1, 1, 10, 1, 1, 1 ],
	[ 1, 1, 10, 10, 23, 5, 18, 5, 1, 1, 1, 1, 23, 10, 1, 1 ],
	[ 18, 1, 24, 1, 10, 10, 1, 10, 10, 1, 1, 21, 1, 1, 19, 22 ]
],
"objects": [
	{
		"x": -256,
		"y": 640,
		"type": "HAUNTED_TREE"
	},
	{
		"x": -384,
		"y": 512,
		"type": "HAUNTED_TREE"
	},
	{
		"x": -448,
		"y": 736,
		"type": "HAUNTED_TREE"
	},
	{
		"x": -416,
		"y": 928,
		"type": "HAUNTED_TREE"
	},
	{
		"x": -160,
		"y": 512,
		"type": "HAUNTED_TREE"
	},
	{
		"x": -64,
		"y": 864,
		"type": "HAUNTED_TREE"
	},
	{
		"x": -96,
		"y": 736,
		"type": "HAUNTED_TREE"
	},
	{
		"x": -224,
		"y": 896,
		"type": "HAUNTED_TREE"
	},
	{
		"x": -512,
		"y": 512,
		"type": "HAUNTED_TREE"
	},
	{
		"x": -32,
		"y": 608,
		"type": "HAUNTED_TREE"
	},
	{
		"x": -64,
		"y": 992,
		"type": "HAUNTED_TREE"
	},
	{
		"x": -256,
		"y": 768,
		"type": "HAUNTED_TREE"
	},
	{
		"x": -128,
		"y": 864,
		"type": "POKEBALL"
	}
]
}