{
"x": 28,
"y": -18,
"biomeType": "FOREST",
"tileData": [
	[ 11, 1, 12, 20, 12, 11, 12, 11, 11, 1, 12, 1, 12, 12, 11, 12 ],
	[ 11, 11, 12, 11, 12, 1, 11, 11, 11, 11, 11, 11, 11, 11, 11, 11 ],
	[ 10, 11, 1, 12, 11, 11, 11, 10, 11, 11, 1, 11, 11, 10, 20, 20 ],
	[ 11, 11, 11, 11, 11, 11, 1, 11, 10, 11, 12, 11, 12, 1, 11, 11 ],
	[ 11, 11, 11, 11, 11, 11, 11, 11, 11, 11, 11, 10, 1, 11, 10, 11 ],
	[ 12, 10, 11, 10, 11, 11, 11, 11, 11, 11, 11, 12, 1, 12, 11, 11 ],
	[ 12, 11, 11, 11, 12, 11, 12, 11, 11, 12, 1, 11, 12, 11, 10, 11 ],
	[ 11, 11, 1, 20, 12, 1, 12, 11, 10, 12, 12, 11, 12, 11, 11, 12 ],
	[ 11, 1, 11, 11, 12, 11, 11, 11, 1, 12, 11, 10, 11, 11, 11, 1 ],
	[ 11, 12, 12, 12, 11, 11, 11, 12, 12, 12, 11, 11, 1, 1, 11, 11 ],
	[ 11, 11, 12, 10, 11, 11, 11, 10, 10, 1, 10, 1, 1, 1, 1, 1 ],
	[ 11, 10, 12, 1, 1, 1, 11, 1, 1, 11, 1, 12, 1, 12, 1, 21 ],
	[ 12, 1, 1, 11, 11, 11, 11, 1, 1, 1, 1, 1, 10, 1, 1, 1 ],
	[ 1, 11, 1, 11, 1, 1, 1, 1, 1, 1, 1, 10, 23, 1, 1, 1 ],
	[ 11, 1, 1, 1, 1, 10, 1, 1, 20, 1, 10, 1, 20, 1, 1, 1 ],
	[ 1, 1, 1, 1, 24, 10, 1, 1, 18, 1, 20, 21, 10, 1, 18, 24 ]
],
"objects": [
	{
		"x": 14592,
		"y": -9088,
		"type": "TREE_0"
	},
	{
		"x": 14464,
		"y": -9216,
		"type": "TREE_0"
	},
	{
		"x": 14624,
		"y": -8864,
		"type": "TREE_0"
	},
	{
		"x": 14400,
		"y": -8992,
		"type": "TREE_0"
	},
	{
		"x": 14432,
		"y": -8800,
		"type": "TREE_0"
	},
	{
		"x": 14688,
		"y": -9216,
		"type": "TREE_0"
	},
	{
		"x": 14784,
		"y": -8864,
		"type": "TREE_0"
	},
	{
		"x": 14720,
		"y": -8992,
		"type": "TREE_0"
	},
	{
		"x": 14336,
		"y": -9216,
		"type": "TREE_0"
	},
	{
		"x": 14816,
		"y": -9120,
		"type": "TREE_0"
	},
	{
		"x": 14784,
		"y": -8736,
		"type": "TREE_0"
	},
	{
		"x": 14624,
		"y": -8736,
		"type": "TREE_1"
	}
]
}