{
"x": 28,
"y": -23,
"biomeType": "HAUNTED",
"tileData": [
	[ 5, 9, 7, 7, 7, 1, 8, 5, 1, 5, 7, 7, 7, 5, 5, 5 ],
	[ 7, 5, 5, 7, 5, 7, 5, 5, 7, 7, 5, 7, 1, 5, 5, 7 ],
	[ 7, 7, 5, 7, 5, 5, 8, 9, 7, 7, 7, 9, 5, 1, 5, 7 ],
	[ 7, 5, 5, 7, 5, 7, 5, 7, 5, 8, 8, 5, 7, 7, 7, 5 ],
	[ 5, 5, 7, 7, 5, 5, 5, 5, 8, 9, 5, 5, 7, 5, 7, 5 ],
	[ 8, 5, 1, 5, 5, 5, 7, 8, 5, 5, 7, 5, 5, 7, 7, 5 ],
	[ 7, 5, 7, 5, 5, 5, 7, 5, 7, 5, 5, 5, 5, 7, 5, 5 ],
	[ 5, 5, 5, 5, 5, 7, 8, 7, 5, 7, 7, 5, 5, 5, 7, 5 ],
	[ 7, 7, 5, 7, 5, 5, 5, 5, 7, 5, 5, 7, 7, 5, 7, 5 ],
	[ 5, 5, 5, 7, 9, 5, 8, 5, 5, 5, 5, 8, 5, 5, 5, 5 ],
	[ 7, 7, 5, 7, 5, 7, 5, 7, 5, 5, 7, 5, 5, 7, 5, 7 ],
	[ 1, 8, 7, 7, 5, 5, 5, 5, 5, 1, 7, 7, 5, 5, 5, 9 ],
	[ 21, 24, 1, 1, 22, 5, 7, 9, 7, 7, 7, 5, 5, 7, 7, 5 ],
	[ 1, 1, 1, 1, 1, 5, 1, 8, 10, 8, 8, 5, 5, 5, 5, 1 ],
	[ 1, 1, 1, 1, 10, 10, 10, 10, 5, 10, 7, 1, 5, 7, 1, 9 ],
	[ 1, 10, 1, 1, 10, 18, 10, 10, 1, 10, 1, 1, 1, 1, 1, 1 ]
],
"objects": [
	{
		"x": 14592,
		"y": -11648,
		"type": "HAUNTED_TREE"
	},
	{
		"x": 14464,
		"y": -11776,
		"type": "HAUNTED_TREE"
	},
	{
		"x": 14624,
		"y": -11424,
		"type": "HAUNTED_TREE"
	},
	{
		"x": 14400,
		"y": -11552,
		"type": "HAUNTED_TREE"
	},
	{
		"x": 14432,
		"y": -11360,
		"type": "HAUNTED_TREE"
	},
	{
		"x": 14688,
		"y": -11776,
		"type": "HAUNTED_TREE"
	},
	{
		"x": 14784,
		"y": -11424,
		"type": "HAUNTED_TREE"
	},
	{
		"x": 14720,
		"y": -11552,
		"type": "HAUNTED_TREE"
	},
	{
		"x": 14336,
		"y": -11776,
		"type": "HAUNTED_TREE"
	},
	{
		"x": 14816,
		"y": -11680,
		"type": "HAUNTED_TREE"
	},
	{
		"x": 14784,
		"y": -11296,
		"type": "HAUNTED_TREE"
	},
	{
		"x": 14624,
		"y": -11296,
		"type": "HAUNTED_TREE"
	}
]
}