{
"x": 1,
"y": 2,
"biomeType": "PLAINS",
"tileData": [
	[ 1, 1, 18, 1, 24, 1, 1, 1, 1, 20, 19, 1, 1, 1, 1, 1 ],
	[ 1, 1, 10, 1, 1, 1, 10, 1, 1, 1, 1, 1, 19, 1, 1, 10 ],
	[ 1, 1, 1, 1, 10, 1, 1, 1, 1, 1, 19, 20, 10, 1, 1, 1 ],
	[ 21, 1, 23, 1, 1, 1, 1, 1, 21, 1, 10, 1, 1, 1, 24, 1 ],
	[ 1, 1, 18, 1, 1, 1, 21, 24, 10, 1, 10, 1, 1, 20, 18, 21 ],
	[ 1, 1, 1, 1, 10, 1, 1, 1, 1, 1, 1, 18, 23, 20, 1, 10 ],
	[ 18, 1, 1, 21, 20, 1, 19, 22, 1, 10, 21, 1, 23, 20, 1, 10 ],
	[ 10, 1, 21, 22, 1, 19, 10, 10, 1, 1, 18, 1, 10, 20, 10, 1 ],
	[ 1, 1, 1, 1, 20, 1, 10, 1, 1, 1, 1, 1, 18, 10, 1, 1 ],
	[ 20, 10, 1, 10, 1, 1, 1, 1, 21, 1, 24, 1, 1, 1, 1, 1 ],
	[ 1, 1, 1, 22, 1, 10, 10, 1, 1, 1, 1, 1, 1, 1, 1, 1 ],
	[ 1, 1, 1, 1, 1, 1, 1, 1, 1, 1, 1, 1, 1, 1, 1, 19 ],
	[ 1, 10, 1, 1, 10, 24, 1, 1, 1, 1, 1, 10, 1, 10, 10, 23 ],
	[ 24, 1, 1, 10, 10, 10, 21, 10, 1, 1, 19, 22, 1, 21, 10, 1 ],
	[ 1, 10, 1, 1, 22, 18, 1, 1, 1, 10, 18, 10, 1, 22, 1, 1 ],
	[ 1, 1, 18, 1, 10, 22, 10, 1, 1, 1, 1, 10, 10, 1, 10, 1 ]
],
"objects": [
	{
		"x": 768,
		"y": 1152,
		"type": "TREE_0"
	},
	{
		"x": 640,
		"y": 1024,
		"type": "TREE_0"
	},
	{
		"x": 800,
		"y": 1376,
		"type": "TREE_0"
	},
	{
		"x": 576,
		"y": 1248,
		"type": "TREE_0"
	},
	{
		"x": 608,
		"y": 1440,
		"type": "TREE_0"
	},
	{
		"x": 864,
		"y": 1024,
		"type": "TREE_0"
	},
	{
		"x": 960,
		"y": 1376,
		"type": "TREE_0"
	},
	{
		"x": 896,
		"y": 1248,
		"type": "TREE_0"
	},
	{
		"x": 512,
		"y": 1024,
		"type": "TREE_0"
	},
	{
		"x": 992,
		"y": 1120,
		"type": "TREE_0"
	},
	{
		"x": 960,
		"y": 1504,
		"type": "TREE_0"
	},
	{
		"x": 800,
		"y": 1504,
		"type": "TREE_1"
	},
	{
		"x": 832,
		"y": 1440,
		"type": "POKEBALL"
	}
]
}