{
"x": 29,
"y": -21,
"biomeType": "PLAINS",
"tileData": [
	[ 22, 1, 20, 10, 10, 1, 19, 11, 11, 10, 11, 11, 11, 11, 12, 11 ],
	[ 1, 1, 10, 1, 1, 19, 1, 1, 11, 10, 11, 11, 12, 12, 11, 11 ],
	[ 10, 10, 1, 1, 23, 1, 1, 23, 12, 11, 11, 10, 12, 1, 1, 10 ],
	[ 1, 10, 10, 10, 1, 1, 21, 1, 11, 11, 11, 11, 12, 1, 11, 11 ],
	[ 10, 10, 10, 1, 1, 1, 19, 1, 10, 12, 1, 11, 12, 12, 11, 1 ],
	[ 10, 1, 1, 10, 10, 10, 1, 1, 1, 1, 11, 12, 11, 11, 11, 1 ],
	[ 22, 1, 1, 1, 1, 1, 1, 1, 10, 24, 10, 1, 1, 1, 1, 1 ],
	[ 10, 1, 10, 10, 1, 10, 1, 10, 1, 1, 1, 10, 1, 10, 1, 10 ],
	[ 1, 1, 1, 1, 1, 10, 10, 10, 1, 10, 1, 1, 20, 1, 1, 1 ],
	[ 1, 1, 1, 1, 1, 1, 1, 1, 1, 1, 10, 1, 1, 1, 1, 1 ],
	[ 1, 1, 1, 20, 10, 1, 1, 1, 1, 1, 1, 1, 10, 1, 1, 1 ],
	[ 1, 1, 1, 1, 1, 1, 22, 1, 10, 1, 1, 1, 19, 10, 1, 1 ],
	[ 10, 10, 10, 1, 1, 1, 10, 10, 22, 1, 1, 18, 10, 1, 10, 1 ],
	[ 20, 1, 1, 1, 1, 1, 1, 10, 1, 1, 10, 1, 10, 1, 1, 10 ],
	[ 1, 18, 1, 1, 1, 10, 10, 10, 24, 20, 20, 1, 10, 1, 10, 10 ],
	[ 10, 1, 1, 1, 18, 1, 18, 24, 1, 1, 1, 1, 1, 1, 10, 1 ]
],
"objects": [
	{
		"x": 15104,
		"y": -10624,
		"type": "TREE_0"
	},
	{
		"x": 14976,
		"y": -10752,
		"type": "TREE_0"
	},
	{
		"x": 15136,
		"y": -10400,
		"type": "TREE_0"
	},
	{
		"x": 14912,
		"y": -10528,
		"type": "TREE_0"
	},
	{
		"x": 14944,
		"y": -10336,
		"type": "TREE_0"
	},
	{
		"x": 15200,
		"y": -10752,
		"type": "TREE_0"
	},
	{
		"x": 15296,
		"y": -10400,
		"type": "TREE_0"
	},
	{
		"x": 15232,
		"y": -10528,
		"type": "TREE_0"
	},
	{
		"x": 14848,
		"y": -10752,
		"type": "TREE_0"
	},
	{
		"x": 15328,
		"y": -10656,
		"type": "TREE_0"
	},
	{
		"x": 15296,
		"y": -10272,
		"type": "TREE_0"
	},
	{
		"x": 15136,
		"y": -10272,
		"type": "TREE_1"
	}
]
}