{
"x": 23,
"y": -22,
"biomeType": "HAUNTED",
"tileData": [
	[ 7, 5, 5, 5, 7, 5, 5, 7, 5, 5, 9, 8, 7, 5, 5, 5 ],
	[ 7, 5, 5, 5, 7, 8, 1, 7, 5, 5, 5, 5, 7, 5, 5, 5 ],
	[ 5, 9, 5, 5, 7, 5, 5, 7, 9, 5, 5, 5, 5, 5, 7, 8 ],
	[ 7, 5, 5, 5, 9, 5, 5, 5, 5, 5, 5, 5, 5, 5, 5, 7 ],
	[ 5, 5, 5, 5, 7, 5, 7, 5, 5, 5, 7, 7, 7, 5, 5, 5 ],
	[ 5, 5, 5, 5, 5, 9, 7, 5, 5, 5, 7, 7, 5, 5, 5, 5 ],
	[ 5, 5, 8, 9, 9, 5, 5, 5, 9, 5, 1, 8, 5, 5, 5, 5 ],
	[ 5, 8, 7, 9, 7, 5, 5, 5, 5, 7, 7, 5, 5, 5, 5, 5 ],
	[ 7, 5, 7, 7, 5, 7, 7, 9, 5, 5, 5, 5, 5, 5, 5, 7 ],
	[ 5, 5, 7, 5, 7, 8, 5, 8, 5, 5, 5, 7, 7, 5, 1, 9 ],
	[ 5, 8, 5, 5, 9, 8, 7, 8, 5, 5, 5, 5, 7, 5, 8, 7 ],
	[ 7, 5, 9, 5, 7, 5, 5, 5, 5, 5, 5, 5, 7, 1, 5, 5 ],
	[ 5, 7, 5, 5, 7, 5, 5, 5, 5, 5, 5, 9, 7, 7, 5, 5 ],
	[ 7, 7, 5, 5, 5, 5, 5, 5, 1, 7, 5, 8, 5, 5, 5, 7 ],
	[ 5, 5, 7, 5, 5, 5, 7, 8, 5, 7, 7, 5, 5, 7, 5, 5 ],
	[ 5, 5, 5, 5, 5, 7, 8, 5, 5, 5, 5, 5, 5, 5, 7, 5 ]
],
"objects": [
	{
		"x": 12032,
		"y": -11136,
		"type": "HAUNTED_TREE"
	},
	{
		"x": 11904,
		"y": -11264,
		"type": "HAUNTED_TREE"
	},
	{
		"x": 12064,
		"y": -10912,
		"type": "HAUNTED_TREE"
	},
	{
		"x": 11840,
		"y": -11040,
		"type": "HAUNTED_TREE"
	},
	{
		"x": 11872,
		"y": -10848,
		"type": "HAUNTED_TREE"
	},
	{
		"x": 12128,
		"y": -11264,
		"type": "HAUNTED_TREE"
	},
	{
		"x": 12224,
		"y": -10912,
		"type": "HAUNTED_TREE"
	},
	{
		"x": 12160,
		"y": -11040,
		"type": "HAUNTED_TREE"
	},
	{
		"x": 11776,
		"y": -11264,
		"type": "HAUNTED_TREE"
	},
	{
		"x": 12256,
		"y": -11168,
		"type": "HAUNTED_TREE"
	},
	{
		"x": 12224,
		"y": -10784,
		"type": "HAUNTED_TREE"
	},
	{
		"x": 12064,
		"y": -10784,
		"type": "HAUNTED_TREE"
	}
]
}