{
"x": 28,
"y": -21,
"biomeType": "FOREST",
"tileData": [
	[ 1, 1, 10, 1, 1, 1, 1, 10, 1, 1, 1, 22, 1, 10, 10, 1 ],
	[ 1, 22, 10, 1, 10, 1, 10, 18, 1, 1, 19, 19, 1, 1, 21, 1 ],
	[ 19, 1, 1, 10, 1, 1, 1, 10, 1, 10, 1, 1, 1, 1, 19, 1 ],
	[ 1, 1, 1, 1, 10, 18, 20, 1, 10, 1, 10, 10, 1, 1, 1, 20 ],
	[ 1, 1, 1, 1, 22, 10, 1, 1, 1, 10, 10, 1, 23, 12, 24, 11 ],
	[ 1, 10, 1, 1, 1, 10, 1, 10, 11, 11, 11, 11, 10, 12, 10, 11 ],
	[ 1, 1, 1, 1, 1, 1, 10, 11, 12, 10, 10, 11, 11, 12, 11, 11 ],
	[ 10, 19, 1, 1, 1, 11, 1, 11, 10, 11, 12, 11, 12, 11, 11, 11 ],
	[ 10, 1, 22, 1, 18, 1, 10, 11, 12, 1, 1, 1, 11, 11, 1, 12 ],
	[ 1, 22, 10, 1, 1, 12, 1, 11, 11, 12, 12, 11, 10, 12, 12, 11 ],
	[ 1, 1, 1, 10, 1, 20, 24, 12, 11, 12, 11, 11, 1, 11, 20, 1 ],
	[ 20, 20, 1, 1, 11, 11, 11, 1, 11, 11, 11, 12, 1, 11, 11, 12 ],
	[ 1, 1, 1, 1, 1, 1, 11, 12, 11, 11, 10, 11, 11, 10, 11, 11 ],
	[ 1, 1, 20, 10, 1, 1, 11, 11, 12, 12, 1, 11, 1, 12, 11, 12 ],
	[ 10, 18, 1, 1, 1, 1, 10, 11, 20, 12, 11, 1, 12, 11, 11, 1 ],
	[ 1, 1, 22, 19, 10, 1, 1, 12, 11, 12, 1, 12, 11, 11, 1, 20 ]
],
"objects": [
	{
		"x": 14592,
		"y": -10624,
		"type": "TREE_0"
	},
	{
		"x": 14464,
		"y": -10752,
		"type": "TREE_0"
	},
	{
		"x": 14400,
		"y": -10528,
		"type": "TREE_0"
	},
	{
		"x": 14432,
		"y": -10336,
		"type": "TREE_0"
	},
	{
		"x": 14688,
		"y": -10752,
		"type": "TREE_0"
	},
	{
		"x": 14784,
		"y": -10400,
		"type": "TREE_0"
	},
	{
		"x": 14624,
		"y": -10368,
		"type": "TREE_0"
	},
	{
		"x": 14336,
		"y": -10752,
		"type": "TREE_0"
	},
	{
		"x": 14816,
		"y": -10656,
		"type": "TREE_0"
	},
	{
		"x": 14784,
		"y": -10272,
		"type": "TREE_0"
	},
	{
		"x": 14560,
		"y": -10496,
		"type": "TREE_0"
	}
]
}