{
"x": 29,
"y": -20,
"biomeType": "PLAINS",
"tileData": [
	[ 12, 11, 11, 11, 10, 11, 10, 1, 11, 11, 11, 1, 12, 11, 12, 11 ],
	[ 12, 11, 11, 12, 12, 11, 1, 10, 11, 11, 1, 11, 11, 1, 12, 11 ],
	[ 11, 12, 12, 10, 10, 12, 10, 11, 11, 11, 11, 11, 12, 11, 11, 12 ],
	[ 1, 20, 1, 10, 11, 1, 11, 1, 1, 20, 11, 11, 11, 11, 11, 11 ],
	[ 1, 11, 1, 11, 1, 1, 10, 20, 11, 10, 11, 10, 11, 11, 11, 1 ],
	[ 11, 1, 24, 19, 1, 1, 20, 1, 1, 18, 12, 11, 11, 11, 11, 11 ],
	[ 1, 24, 21, 1, 1, 10, 21, 1, 1, 10, 11, 11, 11, 11, 12, 12 ],
	[ 1, 1, 1, 1, 1, 1, 20, 10, 22, 1, 1, 11, 20, 11, 11, 11 ],
	[ 1, 1, 10, 1, 19, 1, 22, 1, 1, 20, 24, 1, 11, 12, 1, 11 ],
	[ 1, 1, 21, 22, 1, 19, 1, 1, 10, 1, 1, 1, 1, 11, 11, 12 ],
	[ 19, 1, 10, 10, 10, 1, 1, 1, 19, 1, 22, 1, 10, 1, 10, 1 ],
	[ 1, 1, 10, 1, 1, 1, 10, 24, 1, 19, 1, 10, 1, 1, 20, 1 ],
	[ 1, 10, 20, 18, 10, 1, 10, 10, 10, 1, 1, 1, 1, 22, 20, 1 ],
	[ 1, 10, 19, 1, 10, 1, 10, 1, 21, 1, 1, 1, 1, 1, 1, 1 ],
	[ 1, 10, 10, 1, 1, 10, 20, 1, 10, 1, 1, 1, 1, 1, 1, 1 ],
	[ 10, 1, 1, 1, 1, 1, 24, 10, 1, 10, 19, 1, 24, 1, 1, 10 ]
],
"objects": [
	{
		"x": 14976,
		"y": -10240,
		"type": "TREE_0"
	},
	{
		"x": 15136,
		"y": -9888,
		"type": "TREE_0"
	},
	{
		"x": 14912,
		"y": -10016,
		"type": "TREE_0"
	},
	{
		"x": 15168,
		"y": -10080,
		"type": "TREE_0"
	},
	{
		"x": 14944,
		"y": -9824,
		"type": "TREE_0"
	},
	{
		"x": 15200,
		"y": -10240,
		"type": "TREE_0"
	},
	{
		"x": 15296,
		"y": -9888,
		"type": "TREE_0"
	},
	{
		"x": 14848,
		"y": -10240,
		"type": "TREE_0"
	},
	{
		"x": 15328,
		"y": -10144,
		"type": "TREE_0"
	},
	{
		"x": 15296,
		"y": -9760,
		"type": "TREE_0"
	},
	{
		"x": 15136,
		"y": -9760,
		"type": "TREE_1"
	},
	{
		"x": 15296,
		"y": -10016,
		"type": "TREE_1"
	},
	{
		"x": 15040,
		"y": -10016,
		"type": "TREE_1"
	}
]
}