{
"x": 2,
"y": -1,
"biomeType": "FOREST",
"tileData": [
	[ 11, 1, 12, 11, 12, 11, 11, 12, 11, 11, 12, 11, 11, 10, 10, 10 ],
	[ 11, 12, 1, 11, 11, 10, 1, 12, 11, 11, 1, 11, 1, 1, 12, 1 ],
	[ 11, 11, 11, 11, 10, 11, 11, 1, 11, 11, 11, 11, 23, 10, 1, 1 ],
	[ 1, 11, 11, 11, 11, 11, 11, 1, 12, 11, 12, 11, 1, 1, 1, 1 ],
	[ 11, 11, 11, 12, 11, 11, 11, 11, 11, 10, 11, 12, 1, 19, 10, 1 ],
	[ 11, 11, 11, 12, 12, 12, 11, 11, 11, 1, 20, 1, 21, 11, 1, 21 ],
	[ 11, 12, 12, 11, 1, 11, 11, 1, 1, 12, 11, 20, 1, 1, 10, 1 ],
	[ 1, 12, 10, 11, 11, 11, 1, 11, 11, 11, 12, 1, 1, 21, 1, 1 ],
	[ 11, 12, 12, 11, 11, 10, 1, 11, 11, 11, 12, 1, 1, 1, 1, 21 ],
	[ 11, 10, 11, 11, 10, 12, 11, 11, 1, 10, 11, 1, 12, 10, 1, 1 ],
	[ 20, 12, 11, 11, 11, 11, 10, 1, 12, 11, 11, 20, 10, 10, 1, 10 ],
	[ 11, 11, 11, 12, 11, 20, 1, 12, 11, 12, 10, 12, 1, 1, 10, 1 ],
	[ 11, 12, 12, 12, 12, 11, 11, 11, 12, 11, 11, 1, 1, 1, 1, 1 ],
	[ 12, 1, 11, 12, 11, 11, 11, 12, 1, 11, 10, 11, 11, 1, 1, 1 ],
	[ 1, 20, 11, 12, 10, 11, 12, 11, 11, 11, 10, 12, 1, 1, 1, 10 ],
	[ 11, 12, 20, 11, 11, 11, 12, 12, 12, 11, 11, 11, 12, 18, 1, 1 ]
],
"objects": [
	{
		"x": 1280,
		"y": -384,
		"type": "TREE_0"
	},
	{
		"x": 1152,
		"y": -512,
		"type": "TREE_0"
	},
	{
		"x": 1312,
		"y": -160,
		"type": "TREE_0"
	},
	{
		"x": 1088,
		"y": -288,
		"type": "TREE_0"
	},
	{
		"x": 1120,
		"y": -96,
		"type": "TREE_0"
	},
	{
		"x": 1376,
		"y": -512,
		"type": "TREE_0"
	},
	{
		"x": 1472,
		"y": -160,
		"type": "TREE_0"
	},
	{
		"x": 1408,
		"y": -288,
		"type": "TREE_0"
	},
	{
		"x": 1024,
		"y": -512,
		"type": "TREE_0"
	},
	{
		"x": 1504,
		"y": -416,
		"type": "TREE_0"
	},
	{
		"x": 1472,
		"y": -32,
		"type": "TREE_0"
	},
	{
		"x": 1312,
		"y": -32,
		"type": "TREE_1"
	},
	{
		"x": 1184,
		"y": -64,
		"type": "POKEBALL"
	}
]
}