{
"x": 3,
"y": -1,
"biomeType": "FOREST",
"tileData": [
	[ 12, 10, 11, 11, 11, 1, 11, 11, 12, 11, 11, 12, 11, 11, 10, 1 ],
	[ 11, 11, 11, 12, 11, 12, 11, 12, 11, 11, 11, 10, 12, 10, 1, 10 ],
	[ 10, 11, 11, 11, 12, 11, 11, 11, 11, 10, 11, 11, 11, 11, 10, 1 ],
	[ 11, 10, 11, 10, 11, 11, 12, 11, 11, 11, 11, 11, 1, 11, 1, 1 ],
	[ 12, 11, 11, 1, 12, 11, 11, 12, 12, 12, 12, 1, 12, 11, 12, 10 ],
	[ 11, 12, 12, 10, 11, 11, 12, 1, 10, 11, 1, 12, 11, 11, 11, 12 ],
	[ 12, 11, 11, 12, 11, 11, 1, 11, 11, 10, 11, 11, 11, 1, 11, 11 ],
	[ 11, 12, 11, 11, 11, 11, 12, 12, 12, 11, 11, 12, 11, 11, 11, 20 ],
	[ 11, 11, 11, 11, 1, 1, 11, 12, 11, 11, 11, 11, 11, 11, 20, 11 ],
	[ 11, 11, 11, 1, 11, 10, 11, 12, 11, 1, 1, 1, 11, 1, 11, 11 ],
	[ 11, 11, 1, 12, 1, 10, 11, 11, 11, 11, 10, 10, 12, 10, 11, 11 ],
	[ 11, 1, 12, 11, 11, 11, 11, 1, 1, 11, 12, 1, 11, 11, 10, 11 ],
	[ 1, 11, 11, 11, 10, 11, 12, 12, 10, 11, 1, 11, 11, 12, 11, 1 ],
	[ 11, 10, 11, 11, 11, 12, 10, 1, 11, 12, 11, 11, 11, 1, 1, 10 ],
	[ 12, 11, 11, 11, 11, 1, 11, 11, 12, 11, 11, 1, 1, 11, 12, 1 ],
	[ 20, 11, 11, 1, 1, 11, 1, 11, 12, 11, 11, 1, 11, 11, 12, 11 ]
],
"objects": [
	{
		"x": 1792,
		"y": -384,
		"type": "TREE_0"
	},
	{
		"x": 1664,
		"y": -512,
		"type": "TREE_0"
	},
	{
		"x": 1824,
		"y": -160,
		"type": "TREE_0"
	},
	{
		"x": 1600,
		"y": -288,
		"type": "TREE_0"
	},
	{
		"x": 1632,
		"y": -96,
		"type": "TREE_0"
	},
	{
		"x": 1888,
		"y": -512,
		"type": "TREE_0"
	},
	{
		"x": 1984,
		"y": -160,
		"type": "TREE_0"
	},
	{
		"x": 1920,
		"y": -288,
		"type": "TREE_0"
	},
	{
		"x": 1536,
		"y": -512,
		"type": "TREE_0"
	},
	{
		"x": 2016,
		"y": -416,
		"type": "TREE_0"
	},
	{
		"x": 1984,
		"y": -32,
		"type": "TREE_0"
	},
	{
		"x": 1824,
		"y": -32,
		"type": "TREE_1"
	}
]
}