{
"x": 25,
"y": -18,
"biomeType": "HAUNTED",
"tileData": [
	[ 7, 7, 7, 5, 5, 1, 5, 5, 5, 5, 5, 5, 1, 5, 5, 8 ],
	[ 5, 7, 5, 5, 7, 5, 5, 8, 5, 5, 7, 8, 7, 5, 5, 1 ],
	[ 5, 8, 5, 5, 5, 5, 7, 5, 7, 1, 5, 5, 7, 7, 5, 7 ],
	[ 5, 7, 5, 5, 7, 5, 7, 5, 9, 8, 5, 5, 7, 7, 5, 5 ],
	[ 5, 5, 5, 5, 5, 5, 7, 5, 1, 7, 7, 7, 5, 5, 5, 7 ],
	[ 7, 7, 5, 5, 7, 5, 8, 7, 5, 5, 7, 7, 5, 5, 5, 5 ],
	[ 5, 5, 5, 8, 7, 9, 5, 5, 7, 7, 9, 7, 7, 5, 7, 7 ],
	[ 5, 5, 7, 5, 5, 5, 5, 7, 1, 1, 5, 7, 5, 5, 5, 5 ],
	[ 1, 5, 1, 9, 5, 5, 7, 5, 9, 7, 8, 5, 7, 5, 9, 5 ],
	[ 5, 5, 5, 7, 5, 5, 5, 5, 5, 7, 5, 5, 7, 8, 5, 5 ],
	[ 7, 7, 7, 5, 7, 7, 5, 7, 8, 8, 5, 5, 5, 5, 5, 5 ],
	[ 7, 5, 5, 5, 8, 5, 7, 5, 9, 5, 5, 5, 5, 5, 7, 7 ],
	[ 5, 5, 7, 1, 7, 5, 7, 5, 7, 7, 5, 1, 9, 9, 5, 5 ],
	[ 5, 7, 8, 5, 7, 5, 7, 5, 5, 7, 5, 5, 5, 5, 5, 5 ],
	[ 5, 8, 7, 5, 5, 5, 7, 7, 5, 5, 5, 5, 8, 5, 5, 5 ],
	[ 5, 5, 5, 5, 5, 5, 5, 5, 7, 5, 5, 5, 5, 7, 7, 5 ]
],
"objects": [
	{
		"x": 13056,
		"y": -9088,
		"type": "HAUNTED_TREE"
	},
	{
		"x": 12928,
		"y": -9216,
		"type": "HAUNTED_TREE"
	},
	{
		"x": 13088,
		"y": -8864,
		"type": "HAUNTED_TREE"
	},
	{
		"x": 12864,
		"y": -8992,
		"type": "HAUNTED_TREE"
	},
	{
		"x": 12896,
		"y": -8800,
		"type": "HAUNTED_TREE"
	},
	{
		"x": 13152,
		"y": -9216,
		"type": "HAUNTED_TREE"
	},
	{
		"x": 13248,
		"y": -8864,
		"type": "HAUNTED_TREE"
	},
	{
		"x": 13184,
		"y": -8992,
		"type": "HAUNTED_TREE"
	},
	{
		"x": 12800,
		"y": -9216,
		"type": "HAUNTED_TREE"
	},
	{
		"x": 13280,
		"y": -9120,
		"type": "HAUNTED_TREE"
	},
	{
		"x": 13248,
		"y": -8736,
		"type": "HAUNTED_TREE"
	},
	{
		"x": 13088,
		"y": -8736,
		"type": "HAUNTED_TREE"
	}
]
}