{
"x": 3,
"biomeType": "FOREST",
"tileData": [
	[ 1, 11, 12, 11, 11, 11, 12, 11, 11, 12, 10, 11, 10, 1, 11, 11 ],
	[ 1, 1, 21, 11, 10, 1, 11, 11, 12, 11, 11, 12, 10, 11, 11, 10 ],
	[ 10, 11, 11, 11, 1, 11, 11, 10, 1, 10, 11, 11, 11, 11, 10, 12 ],
	[ 21, 1, 1, 12, 11, 11, 12, 12, 11, 10, 12, 12, 11, 12, 11, 10 ],
	[ 1, 18, 11, 11, 11, 12, 11, 11, 12, 11, 11, 11, 10, 1, 11, 1 ],
	[ 1, 1, 11, 11, 11, 12, 11, 12, 12, 11, 11, 12, 11, 11, 10, 12 ],
	[ 11, 10, 1, 11, 10, 11, 11, 20, 11, 11, 11, 1, 12, 11, 1, 11 ],
	[ 11, 1, 1, 12, 11, 11, 12, 11, 11, 1, 11, 12, 12, 12, 11, 11 ],
	[ 11, 11, 1, 10, 20, 12, 11, 11, 12, 1, 11, 10, 11, 11, 11, 11 ],
	[ 12, 11, 11, 10, 24, 11, 11, 10, 12, 11, 11, 11, 11, 11, 11, 11 ],
	[ 11, 12, 1, 1, 10, 1, 12, 11, 20, 1, 11, 11, 11, 11, 12, 11 ],
	[ 11, 11, 10, 11, 11, 18, 12, 11, 11, 11, 11, 11, 1, 11, 11, 12 ],
	[ 11, 11, 10, 11, 1, 1, 1, 12, 11, 11, 11, 12, 11, 11, 12, 1 ],
	[ 1, 11, 11, 11, 12, 10, 11, 1, 11, 11, 12, 10, 11, 11, 12, 11 ],
	[ 11, 11, 11, 11, 11, 11, 1, 11, 1, 11, 11, 12, 11, 11, 11, 11 ],
	[ 11, 1, 1, 11, 11, 1, 11, 11, 12, 21, 11, 1, 12, 11, 11, 12 ]
],
"objects": [
	{
		"x": 1792,
		"y": 128,
		"type": "TREE_0"
	},
	{
		"x": 1664,
		"type": "TREE_0"
	},
	{
		"x": 1600,
		"y": 224,
		"type": "TREE_0"
	},
	{
		"x": 1664,
		"y": 416,
		"type": "TREE_0"
	},
	{
		"x": 1952,
		"y": 224,
		"type": "TREE_0"
	},
	{
		"x": 1792,
		"y": 288,
		"type": "TREE_0"
	},
	{
		"x": 1536,
		"type": "TREE_0"
	},
	{
		"x": 1920,
		"y": 64,
		"type": "TREE_0"
	},
	{
		"x": 1536,
		"y": 384,
		"type": "TREE_1"
	}
]
}