{
"x": 24,
"y": -21,
"biomeType": "HAUNTED",
"tileData": [
	[ 5, 5, 5, 9, 9, 5, 8, 5, 5, 7, 5, 7, 5, 1, 7, 5 ],
	[ 5, 5, 1, 7, 5, 5, 5, 5, 7, 7, 5, 5, 8, 5, 5, 5 ],
	[ 5, 7, 1, 7, 5, 5, 5, 5, 7, 5, 5, 8, 7, 5, 5, 5 ],
	[ 1, 5, 7, 5, 5, 5, 7, 8, 5, 5, 1, 5, 7, 5, 7, 5 ],
	[ 5, 5, 9, 7, 7, 5, 5, 7, 8, 7, 7, 5, 9, 5, 7, 7 ],
	[ 5, 5, 5, 5, 5, 5, 5, 7, 5, 5, 5, 5, 5, 5, 5, 5 ],
	[ 5, 5, 7, 5, 5, 5, 5, 5, 5, 5, 5, 1, 5, 5, 5, 7 ],
	[ 5, 5, 7, 7, 7, 5, 5, 5, 5, 7, 7, 9, 7, 7, 5, 5 ],
	[ 7, 5, 7, 7, 5, 1, 5, 5, 7, 5, 7, 7, 5, 7, 5, 7 ],
	[ 5, 9, 7, 7, 5, 5, 5, 5, 9, 7, 1, 8, 7, 7, 8, 8 ],
	[ 5, 5, 5, 7, 5, 7, 9, 1, 7, 7, 8, 5, 5, 5, 7, 9 ],
	[ 9, 5, 7, 5, 5, 7, 8, 5, 9, 5, 7, 5, 5, 1, 5, 5 ],
	[ 5, 5, 5, 5, 5, 5, 5, 5, 7, 7, 5, 5, 1, 5, 8, 5 ],
	[ 9, 7, 5, 9, 5, 9, 5, 7, 5, 7, 5, 5, 5, 8, 9, 7 ],
	[ 7, 5, 5, 5, 5, 9, 5, 5, 5, 5, 1, 5, 5, 7, 5, 5 ],
	[ 5, 7, 5, 5, 7, 5, 5, 5, 7, 5, 5, 5, 9, 5, 7, 7 ]
],
"objects": [
	{
		"x": 12544,
		"y": -10624,
		"type": "HAUNTED_TREE"
	},
	{
		"x": 12416,
		"y": -10752,
		"type": "HAUNTED_TREE"
	},
	{
		"x": 12576,
		"y": -10400,
		"type": "HAUNTED_TREE"
	},
	{
		"x": 12352,
		"y": -10528,
		"type": "HAUNTED_TREE"
	},
	{
		"x": 12384,
		"y": -10336,
		"type": "HAUNTED_TREE"
	},
	{
		"x": 12640,
		"y": -10752,
		"type": "HAUNTED_TREE"
	},
	{
		"x": 12736,
		"y": -10400,
		"type": "HAUNTED_TREE"
	},
	{
		"x": 12672,
		"y": -10528,
		"type": "HAUNTED_TREE"
	},
	{
		"x": 12288,
		"y": -10752,
		"type": "HAUNTED_TREE"
	},
	{
		"x": 12768,
		"y": -10656,
		"type": "HAUNTED_TREE"
	},
	{
		"x": 12736,
		"y": -10272,
		"type": "HAUNTED_TREE"
	},
	{
		"x": 12576,
		"y": -10272,
		"type": "HAUNTED_TREE"
	}
]
}