{
"x": 1,
"y": -2,
"biomeType": "FOREST",
"tileData": [
	[ 12, 12, 11, 11, 11, 11, 11, 11, 11, 11, 12, 11, 12, 11, 11, 11 ],
	[ 12, 11, 12, 12, 11, 11, 11, 11, 11, 11, 10, 12, 12, 12, 12, 11 ],
	[ 11, 11, 11, 10, 1, 11, 11, 11, 10, 11, 11, 11, 20, 12, 11, 11 ],
	[ 11, 1, 10, 11, 11, 11, 11, 12, 11, 11, 11, 1, 10, 11, 11, 11 ],
	[ 11, 12, 12, 12, 10, 11, 10, 1, 12, 12, 20, 1, 11, 12, 12, 12 ],
	[ 11, 11, 1, 11, 11, 11, 11, 11, 12, 20, 11, 11, 11, 1, 12, 20 ],
	[ 11, 10, 10, 11, 11, 11, 11, 1, 12, 11, 11, 12, 10, 11, 1, 11 ],
	[ 11, 1, 11, 11, 12, 11, 1, 11, 11, 11, 12, 12, 1, 10, 1, 11 ],
	[ 11, 11, 12, 12, 11, 12, 12, 11, 11, 11, 11, 11, 11, 10, 11, 11 ],
	[ 11, 11, 11, 11, 11, 11, 11, 11, 1, 1, 20, 11, 11, 1, 11, 11 ],
	[ 12, 11, 11, 11, 11, 1, 11, 11, 12, 11, 12, 12, 12, 11, 11, 12 ],
	[ 12, 12, 1, 11, 11, 11, 12, 11, 11, 11, 11, 11, 11, 11, 11, 11 ],
	[ 11, 11, 12, 11, 11, 11, 12, 12, 12, 10, 11, 11, 1, 11, 11, 11 ],
	[ 11, 11, 11, 11, 11, 1, 11, 11, 11, 10, 11, 10, 11, 11, 11, 1 ],
	[ 11, 11, 11, 11, 1, 20, 20, 12, 10, 11, 11, 12, 12, 10, 11, 10 ],
	[ 11, 11, 1, 11, 1, 11, 11, 11, 11, 10, 20, 11, 12, 1, 11, 11 ]
],
"objects": [
	{
		"x": 768,
		"y": -896,
		"type": "TREE_0"
	},
	{
		"x": 640,
		"y": -1024,
		"type": "TREE_0"
	},
	{
		"x": 800,
		"y": -672,
		"type": "TREE_0"
	},
	{
		"x": 576,
		"y": -800,
		"type": "TREE_0"
	},
	{
		"x": 608,
		"y": -608,
		"type": "TREE_0"
	},
	{
		"x": 864,
		"y": -1024,
		"type": "TREE_0"
	},
	{
		"x": 960,
		"y": -672,
		"type": "TREE_0"
	},
	{
		"x": 896,
		"y": -800,
		"type": "TREE_0"
	},
	{
		"x": 512,
		"y": -1024,
		"type": "TREE_0"
	},
	{
		"x": 992,
		"y": -928,
		"type": "TREE_0"
	},
	{
		"x": 960,
		"y": -544,
		"type": "TREE_0"
	},
	{
		"x": 800,
		"y": -544,
		"type": "TREE_1"
	},
	{
		"x": 736,
		"y": -576,
		"type": "POKEBALL"
	}
]
}