{
"x": 1,
"y": -1,
"biomeType": "FOREST",
"tileData": [
	[ 11, 12, 1, 11, 11, 12, 12, 11, 10, 12, 1, 11, 1, 12, 11, 11 ],
	[ 12, 11, 20, 12, 1, 12, 11, 12, 12, 1, 1, 11, 10, 11, 12, 20 ],
	[ 12, 12, 10, 12, 12, 11, 11, 12, 1, 10, 10, 11, 11, 11, 12, 11 ],
	[ 10, 11, 12, 12, 11, 11, 1, 10, 10, 11, 11, 11, 11, 11, 10, 11 ],
	[ 12, 1, 11, 11, 11, 1, 1, 12, 10, 10, 11, 12, 11, 20, 11, 20 ],
	[ 1, 11, 11, 11, 11, 1, 11, 12, 11, 11, 10, 1, 10, 12, 12, 10 ],
	[ 12, 11, 12, 11, 20, 12, 1, 11, 11, 1, 12, 10, 11, 10, 11, 11 ],
	[ 11, 12, 1, 11, 12, 12, 11, 11, 1, 11, 11, 12, 20, 11, 11, 12 ],
	[ 12, 1, 12, 11, 20, 11, 11, 1, 12, 10, 11, 11, 11, 11, 11, 21 ],
	[ 1, 12, 11, 11, 11, 11, 11, 12, 11, 12, 11, 11, 11, 12, 1, 20 ],
	[ 12, 11, 10, 12, 11, 11, 11, 1, 1, 12, 12, 11, 11, 12, 1, 1 ],
	[ 11, 11, 10, 11, 11, 11, 12, 12, 11, 10, 11, 1, 11, 11, 11, 22 ],
	[ 11, 11, 11, 1, 11, 12, 11, 12, 12, 11, 11, 11, 11, 12, 11, 1 ],
	[ 10, 11, 12, 11, 11, 11, 11, 11, 11, 10, 10, 11, 11, 1, 10, 1 ],
	[ 11, 12, 11, 12, 1, 20, 11, 11, 11, 11, 12, 1, 1, 1, 1, 1 ],
	[ 11, 12, 11, 11, 11, 10, 11, 12, 1, 11, 1, 11, 11, 1, 22, 1 ]
],
"objects": [
	{
		"x": 768,
		"y": -384,
		"type": "TREE_0"
	},
	{
		"x": 640,
		"y": -512,
		"type": "TREE_0"
	},
	{
		"x": 800,
		"y": -160,
		"type": "TREE_0"
	},
	{
		"x": 576,
		"y": -288,
		"type": "TREE_0"
	},
	{
		"x": 608,
		"y": -96,
		"type": "TREE_0"
	},
	{
		"x": 864,
		"y": -512,
		"type": "TREE_0"
	},
	{
		"x": 960,
		"y": -160,
		"type": "TREE_0"
	},
	{
		"x": 896,
		"y": -288,
		"type": "TREE_0"
	},
	{
		"x": 512,
		"y": -512,
		"type": "TREE_0"
	},
	{
		"x": 992,
		"y": -416,
		"type": "TREE_0"
	},
	{
		"x": 960,
		"y": -32,
		"type": "TREE_0"
	},
	{
		"x": 800,
		"y": -32,
		"type": "TREE_1"
	},
	{
		"x": 512,
		"y": -128,
		"type": "POKEBALL"
	}
]
}