{
"x": 26,
"y": -21,
"biomeType": "PLAINS",
"tileData": [
	[ 15, 17, 15, 15, 15, 15, 16, 15, 15, 17, 15, 15, 15, 15, 15, 17 ],
	[ 15, 16, 15, 15, 16, 15, 15, 17, 15, 15, 15, 15, 15, 16, 15, 17 ],
	[ 15, 15, 15, 15, 15, 15, 15, 16, 10, 1, 15, 15, 15, 15, 15, 15 ],
	[ 15, 15, 15, 17, 10, 1, 10, 1, 10, 1, 1, 20, 1, 1, 15, 15 ],
	[ 16, 15, 17, 1, 1, 19, 1, 1, 21, 1, 20, 10, 1, 1, 1, 10 ],
	[ 15, 15, 21, 19, 10, 1, 1, 1, 10, 1, 24, 10, 10, 1, 1, 18 ],
	[ 16, 1, 21, 1, 10, 1, 10, 1, 1, 10, 20, 1, 1, 1, 19, 1 ],
	[ 10, 1, 1, 1, 10, 1, 1, 1, 1, 1, 1, 1, 1, 1, 22, 1 ],
	[ 1, 1, 1, 1, 1, 1, 1, 10, 1, 1, 1, 1, 1, 1, 1, 1 ],
	[ 1, 1, 1, 1, 1, 10, 10, 1, 1, 10, 1, 19, 1, 22, 1, 1 ],
	[ 10, 1, 1, 22, 1, 10, 1, 1, 10, 1, 1, 1, 1, 1, 1, 1 ],
	[ 1, 1, 1, 1, 18, 10, 1, 1, 18, 23, 1, 10, 23, 1, 1, 20 ],
	[ 21, 10, 1, 10, 1, 1, 1, 1, 1, 10, 1, 1, 1, 1, 20, 18 ],
	[ 1, 1, 1, 21, 1, 1, 10, 1, 18, 10, 18, 1, 1, 1, 1, 18 ],
	[ 1, 1, 10, 10, 1, 10, 1, 1, 1, 10, 1, 10, 20, 1, 10, 10 ],
	[ 1, 1, 10, 1, 1, 20, 1, 10, 1, 1, 1, 1, 1, 1, 19, 1 ]
],
"objects": [
	{
		"x": 13440,
		"y": -10752,
		"type": "CACTUS"
	},
	{
		"x": 13376,
		"y": -10528,
		"type": "CACTUS"
	},
	{
		"x": 13344,
		"y": -10592,
		"type": "CACTUS"
	},
	{
		"x": 13408,
		"y": -10304,
		"type": "CACTUS"
	},
	{
		"x": 13312,
		"y": -10272,
		"type": "CACTUS"
	},
	{
		"x": 13312,
		"y": -10752,
		"type": "CACTUS"
	},
	{
		"x": 13312,
		"y": -10656,
		"type": "CACTUS"
	},
	{
		"x": 13408,
		"y": -10656,
		"type": "CACTUS"
	},
	{
		"x": 13312,
		"y": -10400,
		"type": "CACTUS"
	},
	{
		"x": 13376,
		"y": -10752,
		"type": "DEAD_TREE"
	},
	{
		"x": 13312,
		"y": -10496,
		"type": "DEAD_TREE"
	},
	{
		"x": 13312,
		"y": -10336,
		"type": "DEAD_TREE"
	}
]
}