{
"x": 2,
"y": 3,
"biomeType": "HAUNTED",
"tileData": [
	[ 5, 8, 5, 5, 5, 5, 5, 5, 5, 5, 5, 5, 1, 8, 5, 1 ],
	[ 5, 7, 5, 5, 5, 7, 5, 5, 5, 7, 5, 9, 5, 7, 9, 5 ],
	[ 8, 7, 5, 5, 5, 5, 7, 5, 5, 5, 5, 5, 5, 5, 5, 5 ],
	[ 7, 5, 7, 1, 5, 5, 8, 5, 5, 7, 5, 5, 9, 5, 5, 5 ],
	[ 5, 9, 7, 7, 5, 5, 7, 7, 5, 7, 7, 5, 5, 5, 5, 8 ],
	[ 9, 8, 9, 5, 5, 5, 5, 5, 5, 7, 5, 5, 5, 5, 8, 5 ],
	[ 5, 7, 5, 5, 7, 5, 7, 7, 1, 7, 7, 7, 5, 9, 7, 5 ],
	[ 5, 9, 5, 5, 5, 7, 5, 7, 7, 5, 5, 5, 7, 8, 1, 5 ],
	[ 4, 9, 5, 5, 8, 7, 5, 9, 5, 5, 5, 7, 9, 5, 5, 5 ],
	[ 4, 4, 4, 4, 5, 5, 5, 7, 5, 5, 7, 9, 5, 9, 1, 5 ],
	[ 4, 4, 4, 1, 4, 4, 1, 7, 5, 1, 5, 1, 8, 7, 5, 5 ],
	[ 4, 4, 4, 4, 6, 4, 4, 4, 4, 4, 5, 9, 5, 5, 5, 8 ],
	[ 4, 4, 4, 4, 1, 4, 4, 1, 1, 4, 4, 4, 5, 7, 7, 7 ],
	[ 4, 4, 4, 1, 4, 4, 4, 4, 4, 6, 4, 4, 4, 4, 7, 7 ],
	[ 4, 4, 4, 4, 4, 4, 4, 4, 4, 4, 4, 4, 4, 4, 4, 4 ],
	[ 6, 1, 4, 4, 1, 1, 4, 4, 4, 4, 4, 4, 4, 4, 4, 4 ]
],
"objects": [
	{
		"x": 1280,
		"y": 1664,
		"type": "HAUNTED_TREE"
	},
	{
		"x": 1152,
		"y": 1536,
		"type": "HAUNTED_TREE"
	},
	{
		"x": 1312,
		"y": 1888,
		"type": "HAUNTED_TREE"
	},
	{
		"x": 1088,
		"y": 1760,
		"type": "HAUNTED_TREE"
	},
	{
		"x": 1120,
		"y": 1952,
		"type": "HAUNTED_TREE"
	},
	{
		"x": 1408,
		"y": 1760,
		"type": "HAUNTED_TREE"
	},
	{
		"x": 1440,
		"y": 1984,
		"type": "HAUNTED_TREE"
	},
	{
		"x": 1024,
		"y": 1536,
		"type": "HAUNTED_TREE"
	},
	{
		"x": 1440,
		"y": 1632,
		"type": "HAUNTED_TREE"
	},
	{
		"x": 1312,
		"y": 2016,
		"type": "HAUNTED_TREE"
	},
	{
		"x": 1344,
		"y": 1632,
		"type": "POKEBALL"
	}
]
}