{
"biomeType": "PLAINS",
"tileData": [
	[ 1, 1, 21, 10, 19, 1, 1, 1, 1, 1, 1, 24, 1, 1, 1, 1 ],
	[ 18, 1, 1, 19, 1, 1, 1, 20, 1, 1, 1, 1, 10, 10, 1, 1 ],
	[ 11, 19, 10, 20, 10, 1, 1, 20, 10, 1, 1, 1, 10, 10, 10, 1 ],
	[ 1, 24, 1, 10, 1, 1, 22, 1, 1, 1, 10, 1, 1, 20, 1, 10 ],
	[ 19, 1, 18, 1, 18, 10, 1, 10, 1, 1, 1, 1, 21, 1, 10, 1 ],
	[ 12, 1, 1, 10, 1, 1, 1, 21, 1, 1, 1, 10, 1, 1, 1, 10 ],
	[ 11, 1, 1, 1, 10, 1, 21, 18, 1, 10, 1, 1, 1, 10, 1, 1 ],
	[ 11, 11, 19, 10, 1, 10, 10, 1, 1, 10, 18, 1, 1, 1, 1, 1 ],
	[ 11, 11, 11, 10, 10, 18, 1, 1, 1, 1, 1, 1, 1, 1, 1, 19 ],
	[ 11, 11, 12, 11, 11, 1, 1, 1, 1, 22, 10, 1, 1, 10, 10, 1 ],
	[ 10, 11, 11, 11, 11, 10, 1, 1, 10, 10, 10, 10, 1, 22, 1, 19 ],
	[ 11, 11, 11, 11, 12, 1, 11, 1, 10, 1, 1, 1, 22, 1, 1, 10 ],
	[ 11, 10, 11, 11, 1, 11, 11, 1, 10, 1, 1, 1, 18, 10, 10, 1 ],
	[ 11, 11, 11, 11, 1, 20, 10, 20, 1, 1, 10, 10, 1, 18, 1, 1 ],
	[ 11, 11, 11, 10, 1, 11, 10, 1, 10, 24, 18, 1, 1, 1, 1, 10 ],
	[ 11, 12, 10, 11, 12, 11, 1, 10, 10, 1, 1, 10, 1, 1, 10, 10 ]
],
"objects": [
	{
		"x": 256,
		"y": 128,
		"type": "TREE_0"
	},
	{
		"x": 128,
		"type": "TREE_0"
	},
	{
		"x": 288,
		"y": 352,
		"type": "TREE_0"
	},
	{
		"x": 64,
		"y": 224,
		"type": "TREE_0"
	},
	{
		"x": 96,
		"y": 416,
		"type": "TREE_0"
	},
	{
		"x": 448,
		"y": 352,
		"type": "TREE_0"
	},
	{
		"x": 384,
		"y": 224,
		"type": "TREE_0"
	},
	{
		"type": "TREE_0"
	},
	{
		"x": 448,
		"y": 480,
		"type": "TREE_0"
	},
	{
		"x": 480,
		"y": 64,
		"type": "TREE_0"
	},
	{
		"x": 320,
		"type": "TREE_0"
	},
	{
		"x": 288,
		"y": 480,
		"type": "TREE_1"
	},
	{
		"x": 320,
		"y": 224,
		"type": "POKEBALL"
	}
]
}