{
"x": 2,
"y": 1,
"biomeType": "FOREST",
"tileData": [
	[ 1, 1, 1, 12, 10, 11, 10, 11, 11, 12, 1, 11, 11, 1, 10, 1 ],
	[ 11, 11, 11, 11, 1, 11, 11, 11, 12, 11, 11, 11, 12, 11, 11, 11 ],
	[ 11, 11, 10, 11, 11, 11, 11, 12, 1, 12, 11, 1, 11, 11, 12, 11 ],
	[ 12, 1, 11, 12, 11, 11, 12, 1, 11, 1, 12, 11, 11, 1, 1, 12 ],
	[ 11, 10, 12, 11, 11, 11, 1, 11, 12, 1, 11, 11, 11, 11, 11, 1 ],
	[ 12, 11, 11, 11, 11, 11, 12, 1, 20, 12, 11, 1, 11, 11, 11, 12 ],
	[ 12, 11, 11, 1, 12, 12, 1, 12, 11, 11, 12, 11, 1, 12, 11, 12 ],
	[ 11, 11, 11, 11, 11, 12, 1, 11, 11, 10, 12, 12, 11, 1, 11, 11 ],
	[ 11, 1, 11, 11, 11, 12, 11, 11, 1, 11, 11, 10, 11, 10, 11, 12 ],
	[ 10, 1, 1, 1, 12, 11, 11, 10, 1, 12, 11, 11, 12, 11, 12, 12 ],
	[ 12, 11, 1, 11, 11, 11, 1, 1, 11, 1, 11, 11, 11, 11, 11, 11 ],
	[ 11, 11, 11, 11, 11, 10, 20, 11, 12, 12, 12, 11, 12, 11, 11, 1 ],
	[ 11, 11, 11, 11, 11, 10, 11, 20, 11, 11, 11, 10, 11, 10, 12, 11 ],
	[ 1, 11, 11, 12, 1, 11, 11, 11, 11, 11, 12, 10, 12, 11, 11, 11 ],
	[ 11, 11, 11, 12, 1, 11, 1, 11, 11, 11, 11, 12, 12, 4, 12, 11 ],
	[ 11, 11, 12, 11, 20, 12, 11, 11, 20, 11, 12, 10, 11, 11, 11, 4 ]
],
"objects": [
	{
		"x": 1280,
		"y": 640,
		"type": "TREE_0"
	},
	{
		"x": 1152,
		"y": 512,
		"type": "TREE_0"
	},
	{
		"x": 1312,
		"y": 864,
		"type": "TREE_0"
	},
	{
		"x": 1088,
		"y": 736,
		"type": "TREE_0"
	},
	{
		"x": 1120,
		"y": 928,
		"type": "TREE_0"
	},
	{
		"x": 1376,
		"y": 512,
		"type": "TREE_0"
	},
	{
		"x": 1472,
		"y": 864,
		"type": "TREE_0"
	},
	{
		"x": 1408,
		"y": 736,
		"type": "TREE_0"
	},
	{
		"x": 1024,
		"y": 512,
		"type": "TREE_0"
	},
	{
		"x": 1504,
		"y": 608,
		"type": "TREE_0"
	},
	{
		"x": 1472,
		"y": 992,
		"type": "TREE_0"
	},
	{
		"x": 1312,
		"y": 992,
		"type": "TREE_1"
	},
	{
		"x": 1056,
		"y": 640,
		"type": "POKEBALL"
	}
]
}