{
"x": 2,
"y": -3,
"biomeType": "FOREST",
"tileData": [
	[ 12, 11, 11, 11, 1, 12, 11, 11, 11, 11, 11, 11, 11, 11, 12, 12 ],
	[ 10, 11, 11, 12, 12, 12, 11, 11, 11, 11, 11, 11, 11, 1, 11, 11 ],
	[ 11, 12, 12, 11, 12, 12, 12, 11, 10, 12, 20, 11, 12, 12, 11, 11 ],
	[ 11, 12, 10, 1, 11, 11, 11, 12, 11, 11, 10, 12, 11, 11, 12, 12 ],
	[ 12, 12, 1, 1, 11, 11, 12, 12, 11, 20, 12, 11, 11, 11, 1, 11 ],
	[ 11, 12, 1, 11, 11, 1, 12, 11, 11, 1, 10, 11, 10, 12, 11, 1 ],
	[ 12, 12, 11, 11, 11, 1, 11, 12, 12, 11, 11, 12, 1, 11, 1, 1 ],
	[ 11, 11, 11, 12, 11, 11, 11, 11, 11, 11, 12, 1, 11, 11, 1, 11 ],
	[ 11, 11, 11, 11, 11, 1, 1, 12, 11, 11, 11, 11, 11, 12, 12, 11 ],
	[ 11, 11, 11, 11, 11, 11, 12, 11, 1, 1, 11, 12, 11, 11, 11, 11 ],
	[ 11, 11, 12, 11, 10, 11, 11, 1, 1, 11, 11, 1, 10, 11, 11, 12 ],
	[ 11, 12, 12, 10, 12, 11, 11, 12, 12, 1, 11, 11, 11, 11, 1, 11 ],
	[ 11, 12, 11, 1, 11, 11, 11, 12, 12, 12, 11, 11, 11, 12, 10, 12 ],
	[ 11, 11, 11, 11, 12, 11, 10, 11, 1, 12, 11, 11, 11, 1, 12, 12 ],
	[ 12, 11, 11, 11, 10, 11, 11, 12, 10, 11, 10, 11, 12, 11, 11, 12 ],
	[ 11, 11, 10, 12, 11, 11, 1, 11, 11, 11, 11, 11, 11, 11, 11, 11 ]
],
"objects": [
	{
		"x": 1280,
		"y": -1408,
		"type": "TREE_0"
	},
	{
		"x": 1152,
		"y": -1536,
		"type": "TREE_0"
	},
	{
		"x": 1312,
		"y": -1184,
		"type": "TREE_0"
	},
	{
		"x": 1088,
		"y": -1312,
		"type": "TREE_0"
	},
	{
		"x": 1120,
		"y": -1120,
		"type": "TREE_0"
	},
	{
		"x": 1376,
		"y": -1536,
		"type": "TREE_0"
	},
	{
		"x": 1472,
		"y": -1184,
		"type": "TREE_0"
	},
	{
		"x": 1408,
		"y": -1312,
		"type": "TREE_0"
	},
	{
		"x": 1024,
		"y": -1536,
		"type": "TREE_0"
	},
	{
		"x": 1504,
		"y": -1440,
		"type": "TREE_0"
	},
	{
		"x": 1472,
		"y": -1056,
		"type": "TREE_0"
	},
	{
		"x": 1312,
		"y": -1056,
		"type": "TREE_1"
	}
]
}