{
"x": -2,
"y": -2,
"biomeType": "PLAINS",
"tileData": [
	[ 1, 1, 1, 10, 10, 1, 10, 1, 1, 10, 10, 1, 10, 1, 20, 10 ],
	[ 1, 1, 1, 10, 10, 21, 1, 1, 1, 1, 1, 10, 1, 18, 1, 1 ],
	[ 10, 20, 1, 1, 10, 10, 1, 1, 1, 1, 19, 20, 19, 1, 1, 1 ],
	[ 1, 19, 10, 10, 1, 1, 10, 1, 1, 1, 20, 1, 1, 10, 1, 1 ],
	[ 1, 18, 1, 1, 1, 18, 1, 1, 1, 1, 10, 1, 1, 20, 24, 20 ],
	[ 10, 1, 20, 10, 1, 10, 10, 1, 1, 20, 1, 1, 1, 10, 10, 1 ],
	[ 24, 1, 10, 1, 1, 10, 1, 10, 1, 1, 1, 1, 1, 1, 20, 10 ],
	[ 1, 1, 1, 1, 1, 22, 1, 1, 1, 1, 1, 1, 1, 1, 1, 1 ],
	[ 11, 11, 20, 20, 10, 1, 20, 1, 10, 1, 1, 1, 20, 1, 1, 1 ],
	[ 11, 10, 11, 10, 1, 1, 1, 10, 1, 1, 1, 22, 18, 1, 10, 21 ],
	[ 10, 11, 11, 11, 21, 1, 1, 21, 18, 1, 1, 18, 1, 10, 1, 1 ],
	[ 12, 11, 11, 11, 11, 1, 20, 10, 10, 24, 20, 1, 10, 1, 10, 1 ],
	[ 12, 12, 11, 11, 12, 11, 11, 10, 10, 1, 1, 1, 1, 1, 1, 10 ],
	[ 1, 11, 11, 11, 1, 11, 12, 1, 11, 11, 1, 20, 1, 10, 23, 21 ],
	[ 11, 11, 11, 11, 12, 10, 12, 11, 11, 11, 12, 11, 12, 1, 1, 1 ],
	[ 11, 10, 10, 11, 11, 20, 1, 11, 11, 12, 12, 11, 12, 18, 11, 11 ]
],
"objects": [
	{
		"x": -768,
		"y": -896,
		"type": "TREE_0"
	},
	{
		"x": -896,
		"y": -1024,
		"type": "TREE_0"
	},
	{
		"x": -736,
		"y": -672,
		"type": "TREE_0"
	},
	{
		"x": -960,
		"y": -800,
		"type": "TREE_0"
	},
	{
		"x": -928,
		"y": -608,
		"type": "TREE_0"
	},
	{
		"x": -640,
		"y": -800,
		"type": "TREE_0"
	},
	{
		"x": -608,
		"y": -576,
		"type": "TREE_0"
	},
	{
		"x": -1024,
		"y": -1024,
		"type": "TREE_0"
	},
	{
		"x": -544,
		"y": -960,
		"type": "TREE_0"
	},
	{
		"x": -704,
		"y": -1024,
		"type": "TREE_0"
	},
	{
		"x": -736,
		"y": -544,
		"type": "TREE_1"
	},
	{
		"x": -672,
		"y": -544,
		"type": "POKEBALL"
	}
]
}