{
"x": 24,
"y": -19,
"biomeType": "HAUNTED",
"tileData": [
	[ 7, 8, 7, 7, 7, 5, 7, 8, 7, 1, 7, 5, 5, 5, 5, 5 ],
	[ 5, 5, 5, 5, 5, 5, 5, 7, 7, 7, 5, 5, 7, 5, 7, 5 ],
	[ 8, 7, 5, 5, 5, 7, 5, 5, 5, 7, 8, 5, 5, 1, 5, 5 ],
	[ 5, 7, 5, 9, 5, 5, 5, 5, 5, 5, 7, 9, 5, 7, 5, 5 ],
	[ 5, 7, 9, 7, 5, 5, 7, 5, 5, 7, 5, 1, 5, 7, 7, 7 ],
	[ 5, 7, 5, 8, 7, 5, 5, 9, 8, 5, 7, 5, 7, 7, 5, 7 ],
	[ 5, 8, 9, 7, 7, 7, 5, 7, 1, 7, 5, 7, 5, 5, 7, 5 ],
	[ 5, 9, 7, 5, 5, 5, 5, 5, 7, 1, 7, 5, 5, 5, 1, 7 ],
	[ 1, 5, 5, 5, 5, 5, 8, 5, 5, 5, 7, 8, 7, 9, 5, 7 ],
	[ 5, 7, 5, 1, 5, 5, 7, 5, 5, 5, 8, 8, 5, 5, 5, 5 ],
	[ 7, 7, 5, 5, 5, 5, 5, 7, 5, 7, 5, 5, 7, 5, 5, 5 ],
	[ 7, 7, 5, 5, 5, 5, 7, 5, 7, 5, 5, 5, 5, 5, 5, 5 ],
	[ 5, 5, 5, 5, 8, 5, 5, 9, 5, 5, 5, 5, 5, 5, 5, 5 ],
	[ 8, 5, 5, 5, 5, 5, 5, 5, 9, 9, 7, 5, 5, 7, 5, 5 ],
	[ 7, 5, 7, 7, 5, 9, 5, 5, 5, 7, 5, 7, 7, 9, 5, 7 ],
	[ 7, 7, 7, 5, 7, 5, 5, 5, 5, 5, 5, 5, 5, 5, 7, 7 ]
],
"objects": [
	{
		"x": 12544,
		"y": -9600,
		"type": "HAUNTED_TREE"
	},
	{
		"x": 12416,
		"y": -9728,
		"type": "HAUNTED_TREE"
	},
	{
		"x": 12576,
		"y": -9376,
		"type": "HAUNTED_TREE"
	},
	{
		"x": 12352,
		"y": -9504,
		"type": "HAUNTED_TREE"
	},
	{
		"x": 12384,
		"y": -9312,
		"type": "HAUNTED_TREE"
	},
	{
		"x": 12640,
		"y": -9728,
		"type": "HAUNTED_TREE"
	},
	{
		"x": 12736,
		"y": -9376,
		"type": "HAUNTED_TREE"
	},
	{
		"x": 12672,
		"y": -9504,
		"type": "HAUNTED_TREE"
	},
	{
		"x": 12288,
		"y": -9728,
		"type": "HAUNTED_TREE"
	},
	{
		"x": 12768,
		"y": -9632,
		"type": "HAUNTED_TREE"
	},
	{
		"x": 12736,
		"y": -9248,
		"type": "HAUNTED_TREE"
	},
	{
		"x": 12576,
		"y": -9248,
		"type": "HAUNTED_TREE"
	}
]
}