{
"x": 3,
"y": -2,
"biomeType": "FOREST",
"tileData": [
	[ 1, 1, 11, 20, 11, 11, 12, 12, 12, 11, 10, 12, 11, 11, 1, 11 ],
	[ 11, 11, 11, 11, 11, 12, 11, 11, 12, 12, 11, 11, 11, 12, 11, 11 ],
	[ 11, 11, 11, 11, 11, 11, 20, 11, 12, 11, 11, 12, 12, 12, 12, 20 ],
	[ 11, 12, 11, 10, 12, 11, 11, 11, 10, 11, 11, 1, 11, 12, 1, 12 ],
	[ 11, 11, 12, 1, 1, 10, 11, 11, 11, 11, 11, 11, 10, 11, 12, 11 ],
	[ 11, 11, 11, 12, 12, 11, 12, 11, 12, 11, 12, 11, 10, 11, 11, 11 ],
	[ 12, 12, 12, 11, 1, 11, 11, 11, 11, 11, 11, 11, 11, 11, 11, 12 ],
	[ 11, 12, 10, 11, 12, 11, 11, 12, 1, 12, 11, 11, 11, 12, 11, 11 ],
	[ 11, 10, 20, 11, 11, 12, 11, 11, 11, 11, 12, 11, 11, 11, 1, 12 ],
	[ 12, 1, 12, 11, 12, 11, 1, 11, 11, 11, 11, 11, 11, 12, 12, 1 ],
	[ 12, 11, 11, 12, 12, 11, 11, 1, 12, 11, 12, 12, 11, 11, 10, 11 ],
	[ 12, 11, 11, 12, 12, 11, 12, 11, 11, 10, 11, 11, 1, 12, 10, 11 ],
	[ 11, 11, 12, 1, 12, 1, 11, 11, 12, 12, 11, 12, 1, 11, 11, 11 ],
	[ 11, 1, 11, 12, 11, 11, 11, 11, 11, 12, 10, 12, 11, 11, 11, 12 ],
	[ 1, 11, 1, 11, 11, 11, 11, 11, 11, 11, 12, 11, 11, 11, 1, 11 ],
	[ 12, 20, 11, 11, 11, 11, 11, 11, 11, 11, 11, 11, 10, 1, 11, 20 ]
],
"objects": [
	{
		"x": 1792,
		"y": -896,
		"type": "TREE_0"
	},
	{
		"x": 1664,
		"y": -1024,
		"type": "TREE_0"
	},
	{
		"x": 1824,
		"y": -672,
		"type": "TREE_0"
	},
	{
		"x": 1600,
		"y": -800,
		"type": "TREE_0"
	},
	{
		"x": 1632,
		"y": -608,
		"type": "TREE_0"
	},
	{
		"x": 1888,
		"y": -1024,
		"type": "TREE_0"
	},
	{
		"x": 1984,
		"y": -672,
		"type": "TREE_0"
	},
	{
		"x": 1920,
		"y": -800,
		"type": "TREE_0"
	},
	{
		"x": 1536,
		"y": -1024,
		"type": "TREE_0"
	},
	{
		"x": 2016,
		"y": -928,
		"type": "TREE_0"
	},
	{
		"x": 1984,
		"y": -544,
		"type": "TREE_0"
	},
	{
		"x": 1824,
		"y": -544,
		"type": "TREE_1"
	}
]
}