{
"x": 28,
"y": -22,
"biomeType": "PLAINS",
"tileData": [
	[ 8, 5, 5, 9, 5, 8, 5, 8, 5, 10, 20, 10, 1, 1, 1, 10 ],
	[ 7, 5, 8, 5, 5, 9, 5, 7, 5, 1, 1, 23, 1, 10, 1, 1 ],
	[ 5, 8, 7, 7, 9, 8, 7, 5, 9, 8, 1, 19, 10, 1, 1, 10 ],
	[ 5, 5, 9, 5, 1, 7, 5, 8, 24, 10, 1, 18, 1, 1, 1, 1 ],
	[ 8, 5, 5, 5, 5, 7, 7, 10, 5, 5, 10, 10, 1, 10, 1, 10 ],
	[ 5, 9, 5, 5, 5, 1, 5, 21, 7, 1, 10, 1, 1, 1, 1, 18 ],
	[ 5, 5, 5, 7, 5, 7, 5, 5, 5, 1, 1, 1, 20, 21, 21, 1 ],
	[ 5, 5, 5, 5, 1, 5, 5, 5, 1, 1, 1, 18, 1, 1, 1, 1 ],
	[ 5, 5, 5, 5, 7, 5, 1, 5, 10, 10, 10, 1, 1, 1, 1, 10 ],
	[ 5, 7, 5, 5, 5, 1, 1, 5, 18, 1, 1, 23, 10, 1, 1, 1 ],
	[ 5, 5, 7, 8, 7, 1, 10, 10, 10, 1, 1, 1, 1, 10, 20, 1 ],
	[ 5, 7, 7, 1, 7, 1, 8, 20, 1, 1, 1, 1, 10, 10, 1, 1 ],
	[ 9, 1, 8, 1, 1, 18, 10, 1, 1, 1, 1, 10, 1, 1, 1, 1 ],
	[ 5, 5, 5, 7, 9, 21, 1, 1, 1, 1, 10, 18, 20, 1, 1, 22 ],
	[ 5, 1, 7, 1, 10, 1, 19, 19, 1, 1, 20, 1, 1, 19, 10, 1 ],
	[ 1, 1, 1, 10, 22, 18, 1, 1, 10, 1, 10, 1, 1, 1, 1, 1 ]
],
"objects": [
	{
		"x": 14592,
		"y": -11136,
		"type": "HAUNTED_TREE"
	},
	{
		"x": 14464,
		"y": -11264,
		"type": "HAUNTED_TREE"
	},
	{
		"x": 14400,
		"y": -11040,
		"type": "HAUNTED_TREE"
	},
	{
		"x": 14432,
		"y": -10848,
		"type": "HAUNTED_TREE"
	},
	{
		"x": 14688,
		"y": -11264,
		"type": "HAUNTED_TREE"
	},
	{
		"x": 14784,
		"y": -10912,
		"type": "HAUNTED_TREE"
	},
	{
		"x": 14720,
		"y": -11040,
		"type": "HAUNTED_TREE"
	},
	{
		"x": 14624,
		"y": -10816,
		"type": "HAUNTED_TREE"
	},
	{
		"x": 14336,
		"y": -11264,
		"type": "HAUNTED_TREE"
	},
	{
		"x": 14528,
		"y": -10976,
		"type": "HAUNTED_TREE"
	},
	{
		"x": 14784,
		"y": -10784,
		"type": "HAUNTED_TREE"
	},
	{
		"x": 14816,
		"y": -11200,
		"type": "HAUNTED_TREE"
	}
]
}